developmental.treatment.id,web,ID,ID.trial.order,web.trial.order,time,location.order,location,attacked,retreated,retreat.latency,own.web,subject.weight.at.boxing,weight.at.boxing,diff.weight,capture.date,maturity.date,population,bin,gum.web,struc.web,web.weight.web,gum.id,struc.id,web.weight.id,abs.diff.gum,abs.diff.struc,abs.diff.web.weight,diff.gum,diff.struc,diff.web.weight,developmental.treatment.web
HI,WBB49,BB11,13,3,1719,1,F,0,NA,NA,NO,559,786,-227,20140822,20141112,BB,1,0,18,7098,0,49,2569,0,31,4529,0,31,-4529,HI
HI,WBB49,BB11,13,3,1719,3,N,0,NA,NA,NO,559,786,-227,20140822,20141112,BB,1,0,18,7098,0,49,2569,0,31,4529,0,31,-4529,HI
HI,WBB31,BB29,1,3,1712,1,F,0,NA,NA,NO,816,796,20,20140917,20141112,BB,2,6,11,3338,0,30,4234,6,19,896,-6,19,896,HI
HI,WBB12,MS39,4,2,1428,1,F,0,NA,NA,NO,765,250,515,20140918,20141015,MS,1,40,12,1789,0,31,6885,40,19,5096,-40,19,5096,LO
HI,WBB59,BB59,7,1,1154,2,M,0,NA,NA,YES,1007,1007,0,20140917,20141119,BB,3,0,24,7336,0,24,7336,0,0,0,0,0,0,HI
HI,WBB12,MS39,4,2,1428,2,N,0,NA,NA,NO,765,250,515,20140918,20141015,MS,1,40,12,1789,0,31,6885,40,19,5096,-40,19,5096,LO
HI,WMS12,MS69,13,1,1203,1,N,0,NA,NA,NO,787,267,520,20140917,20141126,MS,3,65,8,1809,0,11,2748,65,3,939,-65,3,939,LO
HI,WBB11,BB57,16,3,1726,3,M,0,NA,NA,NO,734,559,175,20140917,20141015,BB,1,0,49,2569,0,35,5319,0,14,2750,0,-14,2750,HI
HI,WBB31,BB31,7,1,1259,3,N,0,NA,NA,YES,796,796,0,20140917,20141104,BB,2,6,11,3338,6,11,3338,0,0,0,0,0,0,HI
HI,WBB21,BB21,20,1,1225,2,M,0,NA,NA,YES,914,914,0,20140822,20141008,BB,1,0,28,4403,0,28,4403,0,0,0,0,0,0,HI
HI,WBB13,BB49,4,3,1659,1,F,0,NA,NA,NO,786,877,-91,20140917,20141008,BB,1,0,33,5273,0,18,7098,0,15,1825,0,-15,1825,HI
HI,WBB12,BB11,11,1,1204,3,F,0,NA,NA,NO,559,250,309,20140822,20141112,BB,1,40,12,1789,0,49,2569,40,37,780,-40,37,780,LO
HI,WBB58,BB21,15,3,1724,3,M,0,NA,NA,NO,914,356,558,20140822,20141008,BB,1,9,25,2683,0,28,4403,9,3,1720,-9,3,1720,LO
HI,WBB49,BB49,15,1,1214,1,N,0,NA,NA,YES,786,786,0,20140917,20141008,BB,1,0,18,7098,0,18,7098,0,0,0,0,0,0,HI
HI,WBB11,BB11,7,2,1435,2,M,0,NA,NA,YES,559,559,0,20140822,20141112,BB,1,0,49,2569,0,49,2569,0,0,0,0,0,0,HI
HI,WBB16,BB49,6,2,1431,2,F,0,NA,NA,NO,786,315,471,20140917,20141008,BB,1,26,13,2331,0,18,7098,26,5,4767,-26,5,4767,LO
HI,WBB58,BB21,15,3,1724,1,N,0,NA,NA,NO,914,356,558,20140822,20141008,BB,1,9,25,2683,0,28,4403,9,3,1720,-9,3,1720,LO
HI,WMS12,MS69,13,1,1203,2,M,0,NA,NA,NO,787,267,520,20140917,20141126,MS,3,65,8,1809,0,11,2748,65,3,939,-65,3,939,LO
HI,WBB13,BB13,18,1,1220,3,N,0,NA,NA,YES,877,877,0,20140822,20141015,BB,1,0,33,5273,0,33,5273,0,0,0,0,0,0,HI
HI,WBB57,MS47,21,3,1737,3,F,0,NA,NA,NO,861,734,127,20140917,20141022,MS,1,0,35,5319,0,62,9466,0,27,4147,0,27,4147,HI
HI,WMS12,MS69,13,1,1203,3,F,NA,NA,NA,NO,787,267,520,20140917,20141126,MS,3,65,8,1809,0,11,2748,65,3,939,-65,3,939,LO
HI,WBB49,BB49,15,1,1214,3,M,0,NA,NA,YES,786,786,0,20140917,20141008,BB,1,0,18,7098,0,18,7098,0,0,0,0,0,0,HI
HI,WBB16,BB49,6,2,1431,1,M,0,NA,NA,NO,786,315,471,20140917,20141008,BB,1,26,13,2331,0,18,7098,26,5,4767,-26,5,4767,LO
HI,WBB12,MS39,4,2,1428,3,M,0,NA,NA,NO,765,250,515,20140918,20141015,MS,1,40,12,1789,0,31,6885,40,19,5096,-40,19,5096,LO
HI,WBB21,MS25,1,2,1424,1,N,0,NA,NA,NO,687,914,-227,20140821,20141015,MS,1,0,28,4403,0,28,4587,0,0,184,0,0,184,HI
HI,WBB9,BB9,7,3,1707,1,F,0,NA,NA,YES,579,579,0,20140822,20141015,BB,1,0,24,3913,0,24,3913,0,0,0,0,0,0,HI
HI,WBB12,BB11,11,1,1204,2,N,0,NA,NA,NO,559,250,309,20140822,20141112,BB,1,40,12,1789,0,49,2569,40,37,780,-40,37,780,LO
HI,WBB12,BB11,11,1,1204,1,M,0,NA,NA,NO,559,250,309,20140822,20141112,BB,1,40,12,1789,0,49,2569,40,37,780,-40,37,780,LO
HI,WBB29,BB33,4,1,1252,2,F,0,NA,NA,NO,892,816,76,20140917,20141112,BB,2,0,30,4234,0,42,6525,0,12,2291,0,12,2291,HI
HI,WBB59,BB59,7,1,1154,3,F,0,NA,NA,YES,1007,1007,0,20140917,20141119,BB,3,0,24,7336,0,24,7336,0,0,0,0,0,0,HI
HI,WBB52,MS104,23,3,1703,2,N,0,NA,NA,NO,511,202,309,20141008,20141126,MS,3,37,10,1225,0,3,1366,37,7,141,-37,-7,141,LO
HI,WBB21,MS25,1,2,1424,2,M,0,NA,NA,NO,687,914,-227,20140821,20141015,MS,1,0,28,4403,0,28,4587,0,0,184,0,0,184,HI
HI,WBB58,MS21,3,1,1150,3,M,0,NA,NA,NO,885,356,529,20140821,20141008,MS,1,9,25,2683,0,13,6104,9,12,3421,-9,-12,3421,LO
HI,WBB29,BB29,8,2,1520,1,N,0,NA,NA,YES,816,816,0,20140917,20141112,BB,2,0,30,4234,0,30,4234,0,0,0,0,0,0,HI
HI,WMS19,MS19,19,3,1734,3,N,0,NA,NA,YES,805,805,0,20140822,20141008,MS,1,0,28,6634,0,28,6634,0,0,0,0,0,0,HI
HI,WMS19,BB13,19,2,1502,3,M,0,NA,NA,NO,877,805,72,20140822,20141015,BB,1,0,28,6634,0,33,5273,0,5,1361,0,5,-1361,HI
HI,WBB9,MS25,4,1,1152,2,N,0,NA,NA,NO,687,579,108,20140821,20141015,MS,1,0,24,3913,0,28,4587,0,4,674,0,4,674,HI
HI,WBB43,BB53,1,2,1508,3,N,0,NA,NA,NO,723,779,-56,20140917,20141112,BB,2,0,25,4157,0,45,8014,0,20,3857,0,20,3857,HI
HI,WBB16,BB49,6,2,1431,3,N,0,NA,NA,NO,786,315,471,20140917,20141008,BB,1,26,13,2331,0,18,7098,26,5,4767,-26,5,4767,LO
HI,WBB57,MS17,17,2,1455,1,M,1,1,7,NO,802,734,68,20140821,20141008,MS,1,0,35,5319,0,24,5481,0,11,162,0,-11,162,HI
HI,WBB13,MS19,11,2,1442,3,F,0,NA,NA,NO,805,877,-72,20140822,20141008,MS,1,0,33,5273,0,28,6634,0,5,1361,0,-5,1361,HI
HI,WBB11,BB57,16,3,1726,1,F,0,NA,NA,NO,734,559,175,20140917,20141015,BB,1,0,49,2569,0,35,5319,0,14,2750,0,-14,2750,HI
HI,WMS25,MS25,2,3,1657,3,F,0,NA,NA,YES,687,687,0,20140821,20141015,MS,1,0,28,4587,0,28,4587,0,0,0,0,0,0,HI
HI,WBB21,BB21,20,1,1225,3,N,0,NA,NA,YES,914,914,0,20140822,20141008,BB,1,0,28,4403,0,28,4403,0,0,0,0,0,0,HI
HI,WBB31,BB31,7,1,1259,2,M,0,NA,NA,YES,796,796,0,20140917,20141104,BB,2,6,11,3338,6,11,3338,0,0,0,0,0,0,HI
HI,WBB13,BB49,4,3,1659,3,M,0,NA,NA,NO,786,877,-91,20140917,20141008,BB,1,0,33,5273,0,18,7098,0,15,1825,0,-15,1825,HI
HI,WMS104,MS104,19,1,1214,3,F,0,NA,NA,YES,511,511,0,20141008,20141126,MS,3,0,3,1366,0,3,1366,0,0,0,0,0,0,HI
HI,WMS14,MS35,1,1,1148,1,N,0,NA,NA,NO,869,339,530,20140917,20141015,MS,1,1,24,3535,0,37,6933,1,13,3398,-1,13,3398,LO
HI,WBB31,BB31,7,1,1259,1,F,0,NA,NA,YES,796,796,0,20140917,20141104,BB,2,6,11,3338,6,11,3338,0,0,0,0,0,0,HI
HI,WBB31,BB29,1,3,1712,2,M,0,NA,NA,NO,816,796,20,20140917,20141112,BB,2,6,11,3338,0,30,4234,6,19,896,-6,19,896,HI
HI,WMS104,MS104,19,1,1214,2,M,0,NA,NA,YES,511,511,0,20141008,20141126,MS,3,0,3,1366,0,3,1366,0,0,0,0,0,0,HI
HI,WMS104,MS104,19,1,1214,1,N,1,0,10,YES,511,511,0,20141008,20141126,MS,3,0,3,1366,0,3,1366,0,0,0,0,0,0,HI
HI,WBB11,BB11,7,2,1435,1,N,0,NA,NA,YES,559,559,0,20140822,20141112,BB,1,0,49,2569,0,49,2569,0,0,0,0,0,0,HI
HI,WBB57,MS47,21,3,1737,1,M,0,NA,NA,NO,861,734,127,20140917,20141022,MS,1,0,35,5319,0,62,9466,0,27,4147,0,27,4147,HI
HI,WBB33,BB33,16,3,1736,1,F,0,NA,NA,YES,892,892,0,20140917,20141112,BB,2,0,42,6525,0,42,6525,0,0,0,0,0,0,HI
HI,WBB33,MS59,19,1,1318,2,M,0,NA,NA,NO,909,892,17,20140917,20141112,MS,2,0,42,6525,0,28,4502,0,14,2023,0,-14,-2023,HI
HI,WBB49,BB11,13,3,1719,2,M,0,NA,NA,NO,559,786,-227,20140822,20141112,BB,1,0,18,7098,0,49,2569,0,31,4529,0,31,-4529,HI
HI,WMS21,BB13,9,3,1711,3,M,0,NA,NA,NO,877,885,-8,20140822,20141015,BB,1,0,13,6104,0,33,5273,0,20,831,0,20,-831,HI
HI,WMS22,BB9,20,2,1503,3,F,0,NA,NA,NO,579,258,321,20140822,20141015,BB,1,40,9,1362,0,24,3913,40,15,2551,-40,15,2551,LO
HI,WBB29,MS43,4,3,1715,1,F,0,NA,NA,NO,749,816,-67,20140917,20141112,MS,2,0,30,4234,0,3,4004,0,27,230,0,-27,-230,HI
HI,WMS17,MS17,2,1,1149,2,M,0,NA,NA,YES,802,802,0,20140821,20141008,MS,1,0,24,5481,0,24,5481,0,0,0,0,0,0,HI
HI,WBB29,MS43,4,3,1715,2,N,0,NA,NA,NO,749,816,-67,20140917,20141112,MS,2,0,30,4234,0,3,4004,0,27,230,0,-27,-230,HI
HI,WBB29,BB33,4,1,1252,3,M,0,NA,NA,NO,892,816,76,20140917,20141112,BB,2,0,30,4234,0,42,6525,0,12,2291,0,12,2291,HI
HI,WBB52,MS104,23,3,1703,1,M,0,NA,NA,NO,511,202,309,20141008,20141126,MS,3,37,10,1225,0,3,1366,37,7,141,-37,-7,141,LO
HI,WBB49,BB49,15,1,1214,2,F,0,NA,NA,YES,786,786,0,20140917,20141008,BB,1,0,18,7098,0,18,7098,0,0,0,0,0,0,HI
HI,WBB21,BB21,20,1,1225,1,F,0,NA,NA,YES,914,914,0,20140822,20141008,BB,1,0,28,4403,0,28,4403,0,0,0,0,0,0,HI
HI,WMS14,MS35,1,1,1148,2,M,0,NA,NA,NO,869,339,530,20140917,20141015,MS,1,1,24,3535,0,37,6933,1,13,3398,-1,13,3398,LO
HI,WBB53,BB53,13,3,1731,2,M,0,NA,NA,YES,723,723,0,20140917,20141112,BB,2,0,45,8014,0,45,8014,0,0,0,0,0,0,HI
HI,WBB1,MS47,13,2,1448,3,F,0,NA,NA,NO,861,295,566,20140917,20141022,MS,1,56,3,1825,0,62,9466,56,59,7641,-56,59,7641,LO
HI,WBB33,BB33,16,3,1736,2,N,0,NA,NA,YES,892,892,0,20140917,20141112,BB,2,0,42,6525,0,42,6525,0,0,0,0,0,0,HI
HI,WBB9,MS25,4,1,1152,1,F,0,NA,NA,NO,687,579,108,20140821,20141015,MS,1,0,24,3913,0,28,4587,0,4,674,0,4,674,HI
HI,WMS25,BB57,9,2,1438,3,M,0,NA,NA,NO,734,687,47,20140917,20141015,BB,1,0,28,4587,0,35,5319,0,7,732,0,7,732,HI
HI,WBB43,BB31,15,3,1734,2,F,0,NA,NA,NO,796,779,17,20140917,20141104,BB,2,0,25,4157,6,11,3338,6,14,819,6,-14,-819,HI
HI,WBB1,MS21,8,3,1709,2,M,0,NA,NA,NO,885,295,590,20140821,20141008,MS,1,56,3,1825,0,13,6104,56,10,4279,-56,10,4279,LO
HI,WBB1,MS47,13,2,1448,2,M,0,NA,NA,NO,861,295,566,20140917,20141022,MS,1,56,3,1825,0,62,9466,56,59,7641,-56,59,7641,LO
HI,WBB11,BB57,16,3,1726,2,N,0,NA,NA,NO,734,559,175,20140917,20141015,BB,1,0,49,2569,0,35,5319,0,14,2750,0,-14,2750,HI
HI,WBB57,BB57,14,1,1211,3,N,0,NA,NA,YES,734,734,0,20140917,20141015,BB,1,0,35,5319,0,35,5319,0,0,0,0,0,0,HI
HI,WBB11,BB11,7,2,1435,3,F,0,NA,NA,YES,559,559,0,20140822,20141112,BB,1,0,49,2569,0,49,2569,0,0,0,0,0,0,HI
HI,WBB13,BB13,18,1,1220,2,F,0,NA,NA,YES,877,877,0,20140822,20141015,BB,1,0,33,5273,0,33,5273,0,0,0,0,0,0,HI
HI,WMS35,BB9,17,1,1218,3,F,0,NA,NA,NO,579,869,-290,20140822,20141015,BB,1,0,37,6933,0,24,3913,0,13,3020,0,-13,-3020,HI
HI,WBB57,BB57,14,1,1211,2,M,0,NA,NA,YES,734,734,0,20140917,20141015,BB,1,0,35,5319,0,35,5319,0,0,0,0,0,0,HI
HI,WMS19,BB13,19,2,1502,2,F,0,NA,NA,NO,877,805,72,20140822,20141015,BB,1,0,28,6634,0,33,5273,0,5,1361,0,5,-1361,HI
HI,WMS35,BB9,17,1,1218,2,N,0,NA,NA,NO,579,869,-290,20140822,20141015,BB,1,0,37,6933,0,24,3913,0,13,3020,0,-13,-3020,HI
HI,WMS35,BB9,17,1,1218,1,M,0,NA,NA,NO,579,869,-290,20140822,20141015,BB,1,0,37,6933,0,24,3913,0,13,3020,0,-13,-3020,HI
HI,WMS35,MS17,3,3,1658,1,N,0,NA,NA,NO,802,869,-67,20140821,20141008,MS,1,0,37,6933,0,24,5481,0,13,1452,0,-13,-1452,HI
HI,WMS35,MS35,10,2,1440,3,M,0,NA,NA,YES,869,869,0,20140917,20141015,MS,1,0,37,6933,0,37,6933,0,0,0,0,0,0,HI
HI,WMS35,MS35,10,2,1440,1,F,0,NA,NA,YES,869,869,0,20140917,20141015,MS,1,0,37,6933,0,37,6933,0,0,0,0,0,0,HI
HI,WMS37,BB53,5,1,1254,3,F,0,NA,NA,NO,723,718,5,20140917,20141112,BB,2,0,27,5444,0,45,8014,0,18,2570,0,18,2570,HI
HI,WMS37,BB53,5,1,1254,2,N,0,NA,NA,NO,723,718,5,20140917,20141112,BB,2,0,27,5444,0,45,8014,0,18,2570,0,18,2570,HI
HI,WMS37,MS37,10,2,1523,2,F,0,NA,NA,YES,718,718,0,20140917,20141112,MS,2,0,27,5444,0,27,5444,0,0,0,0,0,0,HI
HI,WMS37,MS37,10,2,1523,3,M,0,NA,NA,YES,718,718,0,20140917,20141112,MS,2,0,27,5444,0,27,5444,0,0,0,0,0,0,HI
HI,WBB43,BB53,1,2,1508,1,F,0,NA,NA,NO,723,779,-56,20140917,20141112,BB,2,0,25,4157,0,45,8014,0,20,3857,0,20,3857,HI
HI,WBB50,MS69,17,3,1652,1,M,0,NA,NA,NO,787,193,594,20140917,20141126,MS,3,57,10,1635,0,11,2748,57,1,1113,-57,1,1113,LO
HI,WBB33,MS59,19,1,1318,3,F,0,NA,NA,NO,909,892,17,20140917,20141112,MS,2,0,42,6525,0,28,4502,0,14,2023,0,-14,-2023,HI
HI,WMS38,MS61,7,3,1721,1,F,0,NA,NA,NO,756,498,258,20140917,20141029,MS,2,0,31,4440,0,29,3514,0,2,926,0,-2,-926,LO
HI,WBB50,MS69,17,3,1652,2,N,0,NA,NA,NO,787,193,594,20140917,20141126,MS,3,57,10,1635,0,11,2748,57,1,1113,-57,1,1113,LO
HI,WBB13,MS19,11,2,1442,2,N,0,NA,NA,NO,805,877,-72,20140822,20141008,MS,1,0,33,5273,0,28,6634,0,5,1361,0,-5,1361,HI
HI,WMS14,MS35,1,1,1148,3,F,0,NA,NA,NO,869,339,530,20140917,20141015,MS,1,1,24,3535,0,37,6933,1,13,3398,-1,13,3398,LO
HI,WBB29,BB29,8,2,1520,3,F,0,NA,NA,YES,816,816,0,20140917,20141112,BB,2,0,30,4234,0,30,4234,0,0,0,0,0,0,HI
HI,WBB13,BB13,18,1,1220,1,M,0,NA,NA,YES,877,877,0,20140822,20141015,BB,1,0,33,5273,0,33,5273,0,0,0,0,0,0,HI
HI,WBB29,BB29,8,2,1520,2,M,0,NA,NA,YES,816,816,0,20140917,20141112,BB,2,0,30,4234,0,30,4234,0,0,0,0,0,0,HI
HI,WMS38,MS61,7,3,1721,3,N,0,NA,NA,NO,756,498,258,20140917,20141029,MS,2,0,31,4440,0,29,3514,0,2,926,0,-2,-926,LO
HI,WMS21,BB13,9,3,1711,2,F,0,NA,NA,NO,877,885,-8,20140822,20141015,BB,1,0,13,6104,0,33,5273,0,20,831,0,20,-831,HI
HI,WBB29,BB33,4,1,1252,1,N,0,NA,NA,NO,892,816,76,20140917,20141112,BB,2,0,30,4234,0,42,6525,0,12,2291,0,12,2291,HI
HI,WMS37,MS37,10,2,1523,1,N,0,NA,NA,YES,718,718,0,20140917,20141112,MS,2,0,27,5444,0,27,5444,0,0,0,0,0,0,HI
HI,WMS17,BB21,2,2,1426,1,F,0,NA,NA,NO,914,802,112,20140822,20141008,BB,1,0,24,5481,0,28,4403,0,4,1078,0,4,-1078,HI
HI,WBB53,MS41,8,1,1300,2,M,0,NA,NA,NO,878,723,155,20140917,20141104,MS,2,0,45,8014,0,21,5575,0,24,2439,0,-24,-2439,HI
HI,WBB3,BB33,13,2,1530,3,N,0,NA,NA,NO,892,319,573,20140917,20141112,BB,2,34,19,4167,0,42,6525,34,23,2358,-34,23,2358,LO
HI,WMS17,MS17,2,1,1149,1,F,0,NA,NA,YES,802,802,0,20140821,20141008,MS,1,0,24,5481,0,24,5481,0,0,0,0,0,0,HI
HI,WBB9,BB9,7,3,1707,2,M,0,NA,NA,YES,579,579,0,20140822,20141015,BB,1,0,24,3913,0,24,3913,0,0,0,0,0,0,HI
HI,WBB53,BB53,13,3,1731,3,N,0,NA,NA,YES,723,723,0,20140917,20141112,BB,2,0,45,8014,0,45,8014,0,0,0,0,0,0,HI
HI,WBB1,MS21,8,3,1709,1,F,0,NA,NA,NO,885,295,590,20140821,20141008,MS,1,56,3,1825,0,13,6104,56,10,4279,-56,10,4279,LO
HI,WBB53,MS59,9,2,1522,3,M,0,NA,NA,NO,909,723,186,20140917,20141112,MS,2,0,45,8014,0,28,4502,0,17,3512,0,-17,-3512,HI
HI,WBB53,MS59,9,2,1522,1,F,0,NA,NA,NO,909,723,186,20140917,20141112,MS,2,0,45,8014,0,28,4502,0,17,3512,0,-17,-3512,HI
HI,WBB53,MS41,8,1,1300,1,N,0,NA,NA,NO,878,723,155,20140917,20141104,MS,2,0,45,8014,0,21,5575,0,24,2439,0,-24,-2439,HI
HI,WBB53,MS41,8,1,1300,3,F,0,NA,NA,NO,878,723,155,20140917,20141104,MS,2,0,45,8014,0,21,5575,0,24,2439,0,-24,-2439,HI
HI,WBB43,BB31,15,3,1734,3,M,0,NA,NA,NO,796,779,17,20140917,20141104,BB,2,0,25,4157,6,11,3338,6,14,819,6,-14,-819,HI
HI,WMS18,MS112,2,1,1145,2,M,0,NA,NA,NO,552,139,413,20141008,20141203,MS,3,42,11,731,0,36,3959,42,25,3228,-42,25,3228,LO
HI,WMS35,MS17,3,3,1658,2,F,0,NA,NA,NO,802,869,-67,20140821,20141008,MS,1,0,37,6933,0,24,5481,0,13,1452,0,-13,-1452,HI
HI,WBB57,MS17,17,2,1455,2,F,0,NA,NA,NO,802,734,68,20140821,20141008,MS,1,0,35,5319,0,24,5481,0,11,162,0,-11,162,HI
HI,WMS35,MS17,3,3,1658,3,M,0,NA,NA,NO,802,869,-67,20140821,20141008,MS,1,0,37,6933,0,24,5481,0,13,1452,0,-13,-1452,HI
HI,WMS35,MS35,10,2,1440,2,N,0,NA,NA,YES,869,869,0,20140917,20141015,MS,1,0,37,6933,0,37,6933,0,0,0,0,0,0,HI
HI,WMS41,MS41,3,2,1511,1,N,0,NA,NA,YES,878,878,0,20140917,20141104,MS,2,0,21,5575,0,21,5575,0,0,0,0,0,0,HI
HI,WMS19,BB13,19,2,1502,1,N,0,NA,NA,NO,877,805,72,20140822,20141015,BB,1,0,28,6634,0,33,5273,0,5,1361,0,5,-1361,HI
HI,WBB21,MS25,1,2,1424,3,F,0,NA,NA,NO,687,914,-227,20140821,20141015,MS,1,0,28,4403,0,28,4587,0,0,184,0,0,184,HI
HI,WMS41,MS41,3,2,1511,2,F,0,NA,NA,YES,878,878,0,20140917,20141104,MS,2,0,21,5575,0,21,5575,0,0,0,0,0,0,HI
HI,WMS41,MS41,3,2,1511,3,M,0,NA,NA,YES,878,878,0,20140917,20141104,MS,2,0,21,5575,0,21,5575,0,0,0,0,0,0,HI
HI,WMS41,BB29,11,1,1305,3,F,0,NA,NA,NO,816,878,-62,20140917,20141112,BB,2,0,21,5575,0,30,4234,0,9,1341,0,9,-1341,HI
HI,WMS41,BB29,11,1,1305,2,N,0,NA,NA,NO,816,878,-62,20140917,20141112,BB,2,0,21,5575,0,30,4234,0,9,1341,0,9,-1341,HI
HI,WMS42,MS112,12,3,1643,1,M,0,NA,NA,NO,552,201,351,20141008,20141203,MS,3,36,10,1140,0,36,3959,36,26,2819,-36,26,2819,LO
HI,WBB58,BB21,15,3,1724,2,F,0,NA,NA,NO,914,356,558,20140822,20141008,BB,1,9,25,2683,0,28,4403,9,3,1720,-9,3,1720,LO
HI,WBB58,MS21,3,1,1150,1,N,0,NA,NA,NO,885,356,529,20140821,20141008,MS,1,9,25,2683,0,13,6104,9,12,3421,-9,-12,3421,LO
HI,WMS42,MS112,12,3,1643,2,F,0,NA,NA,NO,552,201,351,20141008,20141203,MS,3,36,10,1140,0,36,3959,36,26,2819,-36,26,2819,LO
HI,WBB13,BB49,4,3,1659,2,N,0,NA,NA,NO,786,877,-91,20140917,20141008,BB,1,0,33,5273,0,18,7098,0,15,1825,0,-15,1825,HI
HI,WMS42,MS112,12,3,1643,3,N,0,NA,NA,NO,552,201,351,20141008,20141203,MS,3,36,10,1140,0,36,3959,36,26,2819,-36,26,2819,LO
HI,WBB59,BB59,7,1,1154,1,N,0,NA,NA,YES,1007,1007,0,20140917,20141119,BB,3,0,24,7336,0,24,7336,0,0,0,0,0,0,HI
HI,WMS21,BB13,9,3,1711,1,N,0,NA,NA,NO,877,885,-8,20140822,20141015,BB,1,0,13,6104,0,33,5273,0,20,831,0,20,-831,HI
HI,WMS21,MS21,5,2,1430,2,N,0,NA,NA,YES,885,885,0,20140821,20141008,MS,1,0,13,6104,0,13,6104,0,0,0,0,0,0,HI
HI,WMS38,MS61,7,3,1721,2,M,0,NA,NA,NO,756,498,258,20140917,20141029,MS,2,0,31,4440,0,29,3514,0,2,926,0,-2,-926,LO
HI,WMS21,MS21,5,2,1430,3,F,0,NA,NA,YES,885,885,0,20140821,20141008,MS,1,0,13,6104,0,13,6104,0,0,0,0,0,0,HI
HI,WBB13,MS19,11,2,1442,1,M,0,NA,NA,NO,805,877,-72,20140822,20141008,MS,1,0,33,5273,0,28,6634,0,5,1361,0,-5,1361,HI
HI,WMS43,BB43,17,2,1536,3,F,0,NA,NA,NO,779,749,30,20140917,20141104,BB,2,0,3,4004,0,25,4157,0,22,153,0,22,153,HI
HI,WMS21,MS21,5,2,1430,1,M,0,NA,NA,YES,885,885,0,20140821,20141008,MS,1,0,13,6104,0,13,6104,0,0,0,0,0,0,HI
HI,WMS43,BB43,17,2,1536,1,M,0,NA,NA,NO,779,749,30,20140917,20141104,BB,2,0,3,4004,0,25,4157,0,22,153,0,22,153,HI
HI,WMS22,MS35,12,3,1715,3,N,0,NA,NA,NO,869,258,611,20140917,20141015,MS,1,40,9,1362,0,37,6933,40,28,5571,-40,28,5571,LO
HI,WMS43,MS43,15,1,1313,1,N,0,NA,NA,YES,749,749,0,20140917,20141112,MS,2,0,3,4004,0,3,4004,0,0,0,0,0,0,HI
HI,WBB29,MS43,4,3,1715,3,M,0,NA,NA,NO,749,816,-67,20140917,20141112,MS,2,0,30,4234,0,3,4004,0,27,230,0,-27,-230,HI
HI,WMS17,MS17,2,1,1149,3,N,0,NA,NA,YES,802,802,0,20140821,20141008,MS,1,0,24,5481,0,24,5481,0,0,0,0,0,0,HI
HI,WMS22,MS35,12,3,1715,1,M,0,NA,NA,NO,869,258,611,20140917,20141015,MS,1,40,9,1362,0,37,6933,40,28,5571,-40,28,5571,LO
HI,WBB9,MS25,4,1,1152,3,M,0,NA,NA,NO,687,579,108,20140821,20141015,MS,1,0,24,3913,0,28,4587,0,4,674,0,4,674,HI
HI,WMS22,BB9,20,2,1503,1,M,0,NA,NA,NO,579,258,321,20140822,20141015,BB,1,40,9,1362,0,24,3913,40,15,2551,-40,15,2551,LO
HI,WMS22,MS35,12,3,1715,2,F,0,NA,NA,NO,869,258,611,20140917,20141015,MS,1,40,9,1362,0,37,6933,40,28,5571,-40,28,5571,LO
HI,WMS22,BB9,20,2,1503,2,N,0,NA,NA,NO,579,258,321,20140822,20141015,BB,1,40,9,1362,0,24,3913,40,15,2551,-40,15,2551,LO
HI,WMS46,MS19,13,1,1209,2,M,0,NA,NA,NO,805,276,529,20140822,20141008,MS,1,38,34,2476,0,28,6634,38,6,4158,-38,-6,4158,LO
HI,WBB3,BB33,13,2,1530,2,M,0,NA,NA,NO,892,319,573,20140917,20141112,BB,2,34,19,4167,0,42,6525,34,23,2358,-34,23,2358,LO
HI,WBB3,BB33,13,2,1530,1,F,0,NA,NA,NO,892,319,573,20140917,20141112,BB,2,34,19,4167,0,42,6525,34,23,2358,-34,23,2358,LO
HI,WMS18,MS112,2,1,1145,3,N,0,NA,NA,NO,552,139,413,20141008,20141203,MS,3,42,11,731,0,36,3959,42,25,3228,-42,25,3228,LO
HI,WMS46,MS19,13,1,1209,1,N,0,NA,NA,NO,805,276,529,20140822,20141008,MS,1,38,34,2476,0,28,6634,38,6,4158,-38,-6,4158,LO
HI,WBB57,BB57,14,1,1211,1,F,0,NA,NA,YES,734,734,0,20140917,20141015,BB,1,0,35,5319,0,35,5319,0,0,0,0,0,0,HI
HI,WMS46,MS19,13,1,1209,3,F,0,NA,NA,NO,805,276,529,20140822,20141008,MS,1,38,34,2476,0,28,6634,38,6,4158,-38,-6,4158,LO
HI,WBB57,MS17,17,2,1455,3,N,1,1,3,NO,802,734,68,20140821,20141008,MS,1,0,35,5319,0,24,5481,0,11,162,0,-11,162,HI
HI,WMS19,MS19,19,3,1734,2,M,0,NA,NA,YES,805,805,0,20140822,20141008,MS,1,0,28,6634,0,28,6634,0,0,0,0,0,0,HI
HI,WMS47,MS47,21,1,1228,2,F,0,NA,NA,YES,861,861,0,20140917,20141022,MS,1,0,62,9466,0,62,9466,0,0,0,0,0,0,HI
HI,WMS47,MS47,21,1,1228,3,N,0,NA,NA,YES,861,861,0,20140917,20141022,MS,1,0,62,9466,0,62,9466,0,0,0,0,0,0,HI
HI,WMS25,MS25,2,3,1657,1,N,0,NA,NA,YES,687,687,0,20140821,20141015,MS,1,0,28,4587,0,28,4587,0,0,0,0,0,0,HI
HI,WMS25,MS25,2,3,1657,2,M,0,NA,NA,YES,687,687,0,20140821,20141015,MS,1,0,28,4587,0,28,4587,0,0,0,0,0,0,HI
HI,WMS47,MS47,21,1,1228,1,M,0,NA,NA,YES,861,861,0,20140917,20141022,MS,1,0,62,9466,0,62,9466,0,0,0,0,0,0,HI
HI,WMS25,MS39,16,1,1216,1,F,0,NA,NA,NO,765,687,78,20140918,20141015,MS,1,0,28,4587,0,31,6885,0,3,2298,0,3,2298,HI
HI,WMS25,BB57,9,2,1438,1,N,0,NA,NA,NO,734,687,47,20140917,20141015,BB,1,0,28,4587,0,35,5319,0,7,732,0,7,732,HI
HI,WMS25,MS39,16,1,1216,2,M,0,NA,NA,NO,765,687,78,20140918,20141015,MS,1,0,28,4587,0,31,6885,0,3,2298,0,3,2298,HI
HI,WMS25,MS39,16,1,1216,3,N,0,NA,NA,NO,765,687,78,20140918,20141015,MS,1,0,28,4587,0,31,6885,0,3,2298,0,3,2298,HI
HI,WMS25,BB57,9,2,1438,2,F,0,NA,NA,NO,734,687,47,20140917,20141015,BB,1,0,28,4587,0,35,5319,0,7,732,0,7,732,HI
HI,WBB31,BB29,1,3,1712,3,N,0,NA,NA,NO,816,796,20,20140917,20141112,BB,2,6,11,3338,0,30,4234,6,19,896,-6,19,896,HI
HI,WBB58,MS21,3,1,1150,2,F,0,NA,NA,NO,885,356,529,20140821,20141008,MS,1,9,25,2683,0,13,6104,9,12,3421,-9,-12,3421,LO
HI,WMS50,MS53,23,1,1219,2,N,0,NA,NA,NO,499,264,235,20140917,20141126,MS,3,22,15,1873,0,41,3900,22,26,2027,-22,26,2027,LO
HI,WMS50,MS53,23,1,1219,3,M,0,NA,NA,NO,499,264,235,20140917,20141126,MS,3,22,15,1873,0,41,3900,22,26,2027,-22,26,2027,LO
HI,WMS50,MS53,23,1,1219,1,F,0,NA,NA,NO,499,264,235,20140917,20141126,MS,3,22,15,1873,0,41,3900,22,26,2027,-22,26,2027,LO
HI,WMS53,MS53,6,3,1633,1,M,0,NA,NA,YES,499,499,0,20140917,20141126,MS,3,0,41,3900,0,41,3900,0,0,0,0,0,0,HI
HI,WMS43,MS43,15,1,1313,2,F,0,NA,NA,YES,749,749,0,20140917,20141112,MS,2,0,3,4004,0,3,4004,0,0,0,0,0,0,HI
HI,WBB33,MS59,19,1,1318,1,N,0,NA,NA,NO,909,892,17,20140917,20141112,MS,2,0,42,6525,0,28,4502,0,14,2023,0,-14,-2023,HI
HI,WMS43,MS43,15,1,1313,3,M,0,NA,NA,YES,749,749,0,20140917,20141112,MS,2,0,3,4004,0,3,4004,0,0,0,0,0,0,HI
HI,WMS53,MS53,6,3,1633,2,F,0,NA,NA,YES,499,499,0,20140917,20141126,MS,3,0,41,3900,0,41,3900,0,0,0,0,0,0,HI
HI,WBB33,BB33,16,3,1736,3,M,0,NA,NA,YES,892,892,0,20140917,20141112,BB,2,0,42,6525,0,42,6525,0,0,0,0,0,0,HI
HI,WMS53,MS53,6,3,1633,3,N,1,1,1,YES,499,499,0,20140917,20141126,MS,3,0,41,3900,0,41,3900,0,0,0,0,0,0,HI
HI,WMS17,BB21,2,2,1426,3,N,0,NA,NA,NO,914,802,112,20140822,20141008,BB,1,0,24,5481,0,28,4403,0,4,1078,0,4,-1078,HI
HI,WMS112,MS112,2,2,1406,2,M,0,NA,NA,YES,552,552,0,20141008,20141203,MS,3,0,36,3959,0,36,3959,0,0,0,0,0,0,HI
HI,WMS58,BB59,5,2,1410,2,N,0,NA,NA,NO,1007,319,688,20140917,20141119,BB,3,32,5,1799,0,24,7336,32,19,5537,-32,19,5537,LO
HI,WBB9,BB9,7,3,1707,3,F,0,NA,NA,YES,579,579,0,20140822,20141015,BB,1,0,24,3913,0,24,3913,0,0,0,0,0,0,HI
HI,WMS58,BB59,5,2,1410,1,M,0,NA,NA,NO,1007,319,688,20140917,20141119,BB,3,32,5,1799,0,24,7336,32,19,5537,-32,19,5537,LO
HI,WMS112,MS112,2,2,1406,3,N,0,NA,NA,YES,552,552,0,20141008,20141203,MS,3,0,36,3959,0,36,3959,0,0,0,0,0,0,HI
HI,WBB1,MS47,13,2,1448,1,N,0,NA,NA,NO,861,295,566,20140917,20141022,MS,1,56,3,1825,0,62,9466,56,59,7641,-56,59,7641,LO
HI,WBB1,MS21,8,3,1709,3,N,0,NA,NA,NO,885,295,590,20140821,20141008,MS,1,56,3,1825,0,13,6104,56,10,4279,-56,10,4279,LO
HI,WBB43,BB43,3,1,1250,3,M,0,NA,NA,YES,779,779,0,20140917,20141104,BB,2,0,25,4157,0,25,4157,0,0,0,0,0,0,HI
HI,WMS112,MS112,2,2,1406,1,F,0,NA,NA,YES,552,552,0,20141008,20141203,MS,3,0,36,3959,0,36,3959,0,0,0,0,0,0,HI
HI,WBB43,BB31,15,3,1734,1,N,0,NA,NA,NO,796,779,17,20140917,20141104,BB,2,0,25,4157,6,11,3338,6,14,819,6,-14,-819,HI
HI,WBB43,BB43,3,1,1250,2,N,0,NA,NA,YES,779,779,0,20140917,20141104,BB,2,0,25,4157,0,25,4157,0,0,0,0,0,0,HI
HI,WBB43,BB43,3,1,1250,1,F,0,NA,NA,YES,779,779,0,20140917,20141104,BB,2,0,25,4157,0,25,4157,0,0,0,0,0,0,HI
HI,WMS59,MS59,11,3,1727,2,N,0,NA,NA,YES,909,909,0,20140917,20141112,MS,2,0,28,4502,0,28,4502,0,0,0,0,0,0,HI
HI,WBB43,BB53,1,2,1508,2,M,0,NA,NA,NO,723,779,-56,20140917,20141112,BB,2,0,25,4157,0,45,8014,0,20,3857,0,20,3857,HI
HI,WMS59,MS59,11,3,1727,3,F,0,NA,NA,YES,909,909,0,20140917,20141112,MS,2,0,28,4502,0,28,4502,0,0,0,0,0,0,HI
HI,WMS59,MS43,11,2,1524,1,M,0,NA,NA,NO,749,909,-160,20140917,20141112,MS,2,0,28,4502,0,3,4004,0,25,498,0,-25,-498,HI
HI,WMS59,MS59,11,3,1727,1,M,0,NA,NA,YES,909,909,0,20140917,20141112,MS,2,0,28,4502,0,28,4502,0,0,0,0,0,0,HI
HI,WMS59,MS43,11,2,1524,3,F,0,NA,NA,NO,749,909,-160,20140917,20141112,MS,2,0,28,4502,0,3,4004,0,25,498,0,-25,-498,HI
HI,WMS59,MS43,11,2,1524,2,N,0,NA,NA,NO,749,909,-160,20140917,20141112,MS,2,0,28,4502,0,3,4004,0,25,498,0,-25,-498,HI
HI,WMS61,MS37,16,1,1314,3,M,0,NA,NA,NO,718,756,-38,20140917,20141112,MS,2,0,29,3514,0,27,5444,0,2,1930,0,-2,1930,HI
HI,WMS61,MS61,4,2,1512,1,F,0,NA,NA,YES,756,756,0,20140917,20141029,MS,2,0,29,3514,0,29,3514,0,0,0,0,0,0,HI
HI,WMS61,MS37,16,1,1314,1,F,0,NA,NA,NO,718,756,-38,20140917,20141112,MS,2,0,29,3514,0,27,5444,0,2,1930,0,-2,1930,HI
HI,WMS61,MS41,8,3,1722,2,M,0,NA,NA,NO,878,756,122,20140917,20141104,MS,2,0,29,3514,0,21,5575,0,8,2061,0,-8,2061,HI
HI,WMS61,MS41,8,3,1722,3,F,0,NA,NA,NO,878,756,122,20140917,20141104,MS,2,0,29,3514,0,21,5575,0,8,2061,0,-8,2061,HI
HI,WMS61,MS41,8,3,1722,1,N,0,NA,NA,NO,878,756,122,20140917,20141104,MS,2,0,29,3514,0,21,5575,0,8,2061,0,-8,2061,HI
HI,WMS61,MS61,4,2,1512,2,N,0,NA,NA,YES,756,756,0,20140917,20141029,MS,2,0,29,3514,0,29,3514,0,0,0,0,0,0,HI
HI,WMS61,MS61,4,2,1512,3,M,0,NA,NA,YES,756,756,0,20140917,20141029,MS,2,0,29,3514,0,29,3514,0,0,0,0,0,0,HI
HI,WMS61,MS37,16,1,1314,2,N,0,NA,NA,NO,718,756,-38,20140917,20141112,MS,2,0,29,3514,0,27,5444,0,2,1930,0,-2,1930,HI
HI,WMS37,BB53,5,1,1254,1,M,0,NA,NA,NO,723,718,5,20140917,20141112,BB,2,0,27,5444,0,45,8014,0,18,2570,0,18,2570,HI
HI,WMS38,BB31,6,2,1515,2,F,0,NA,NA,NO,796,498,298,20140917,20141104,BB,2,0,31,4440,6,11,3338,6,20,1102,6,-20,-1102,LO
HI,WMS64,MS104,10,2,1417,3,M,0,NA,NA,NO,511,316,195,20141008,20141126,MS,3,26,15,1598,0,3,1366,26,12,232,-26,-12,-232,LO
HI,WMS38,BB31,6,2,1515,3,N,0,NA,NA,NO,796,498,298,20140917,20141104,BB,2,0,31,4440,6,11,3338,6,20,1102,6,-20,-1102,LO
HI,WBB50,MS69,17,3,1652,3,F,0,NA,NA,NO,787,193,594,20140917,20141126,MS,3,57,10,1635,0,11,2748,57,1,1113,-57,1,1113,LO
HI,WMS64,MS104,10,2,1417,1,N,0,NA,NA,NO,511,316,195,20141008,20141126,MS,3,26,15,1598,0,3,1366,26,12,232,-26,-12,-232,LO
HI,WMS64,MS104,10,2,1417,2,F,0,NA,NA,NO,511,316,195,20141008,20141126,MS,3,26,15,1598,0,3,1366,26,12,232,-26,-12,-232,LO
HI,WBB52,MS104,23,3,1703,3,F,0,NA,NA,NO,511,202,309,20141008,20141126,MS,3,37,10,1225,0,3,1366,37,7,141,-37,-7,141,LO
HI,WMS38,BB31,6,2,1515,1,M,0,NA,NA,NO,796,498,298,20140917,20141104,BB,2,0,31,4440,6,11,3338,6,20,1102,6,-20,-1102,LO
HI,WMS69,MS69,19,2,1431,1,F,0,NA,NA,YES,787,787,0,20140917,20141126,MS,3,0,11,2748,0,11,2748,0,0,0,0,0,0,HI
HI,WMS17,BB21,2,2,1426,2,M,0,NA,NA,NO,914,802,112,20140822,20141008,BB,1,0,24,5481,0,28,4403,0,4,1078,0,4,-1078,HI
HI,WMS43,BB43,17,2,1536,2,N,0,NA,NA,NO,779,749,30,20140917,20141104,BB,2,0,3,4004,0,25,4157,0,22,153,0,22,153,HI
HI,WMS39,MS39,11,3,1714,2,N,0,NA,NA,YES,765,765,0,20140918,20141015,MS,1,0,31,6885,0,31,6885,0,0,0,0,0,0,HI
HI,WMS69,MS69,19,2,1431,3,N,0,NA,NA,YES,787,787,0,20140917,20141126,MS,3,0,11,2748,0,11,2748,0,0,0,0,0,0,HI
HI,WMS58,BB59,5,2,1410,3,F,0,NA,NA,NO,1007,319,688,20140917,20141119,BB,3,32,5,1799,0,24,7336,32,19,5537,-32,19,5537,LO
HI,WMS69,MS69,19,2,1431,2,M,0,NA,NA,YES,787,787,0,20140917,20141126,MS,3,0,11,2748,0,11,2748,0,0,0,0,0,0,HI
HI,WMS39,MS39,11,3,1714,1,M,0,NA,NA,YES,765,765,0,20140918,20141015,MS,1,0,31,6885,0,31,6885,0,0,0,0,0,0,HI
HI,WBB53,BB53,13,3,1731,1,F,0,NA,NA,YES,723,723,0,20140917,20141112,BB,2,0,45,8014,0,45,8014,0,0,0,0,0,0,HI
HI,WMS39,MS39,11,3,1714,3,F,0,NA,NA,YES,765,765,0,20140918,20141015,MS,1,0,31,6885,0,31,6885,0,0,0,0,0,0,HI
HI,WBB53,MS59,9,2,1522,2,N,0,NA,NA,NO,909,723,186,20140917,20141112,MS,2,0,45,8014,0,28,4502,0,17,3512,0,-17,-3512,HI
HI,WMS18,MS112,2,1,1145,1,F,0,NA,NA,NO,552,139,413,20141008,20141203,MS,3,42,11,731,0,36,3959,42,25,3228,-42,25,3228,LO
HI,WMS70,MS53,22,2,1435,1,N,0,NA,NA,NO,499,281,218,20140917,20141126,MS,3,35,10,2724,0,41,3900,35,31,1176,-35,31,1176,LO
HI,WMS70,BB59,21,3,1700,2,F,0,NA,NA,NO,1007,281,726,20140917,20141119,BB,3,35,10,2724,0,24,7336,35,14,4612,-35,14,4612,LO
HI,WMS70,MS53,22,2,1435,3,M,0,NA,NA,NO,499,281,218,20140917,20141126,MS,3,35,10,2724,0,41,3900,35,31,1176,-35,31,1176,LO
HI,WMS70,BB59,21,3,1700,3,M,0,NA,NA,NO,1007,281,726,20140917,20141119,BB,3,35,10,2724,0,24,7336,35,14,4612,-35,14,4612,LO
HI,WMS70,BB59,21,3,1700,1,N,0,NA,NA,NO,1007,281,726,20140917,20141119,BB,3,35,10,2724,0,24,7336,35,14,4612,-35,14,4612,LO
HI,WMS70,MS53,22,2,1435,2,F,0,NA,NA,NO,499,281,218,20140917,20141126,MS,3,35,10,2724,0,41,3900,35,31,1176,-35,31,1176,LO
HI,WMS8,BB43,18,3,1738,3,N,0,NA,NA,NO,779,381,398,20140917,20141104,BB,2,0,21,2461,0,25,4157,0,4,1696,0,4,1696,LO
HI,WMS19,MS19,19,3,1734,1,F,0,NA,NA,YES,805,805,0,20140822,20141008,MS,1,0,28,6634,0,28,6634,0,0,0,0,0,0,HI
HI,WMS8,BB43,18,3,1738,1,M,0,NA,NA,NO,779,381,398,20140917,20141104,BB,2,0,21,2461,0,25,4157,0,4,1696,0,4,1696,LO
HI,WMS8,MS61,6,1,1255,2,F,0,NA,NA,NO,756,381,375,20140917,20141029,MS,2,0,21,2461,0,29,3514,0,8,1053,0,8,1053,LO
HI,WMS41,BB29,11,1,1305,1,M,0,NA,NA,NO,816,878,-62,20140917,20141112,BB,2,0,21,5575,0,30,4234,0,9,1341,0,9,-1341,HI
HI,WBB57,MS47,21,3,1737,2,N,0,NA,NA,NO,861,734,127,20140917,20141022,MS,1,0,35,5319,0,62,9466,0,27,4147,0,27,4147,HI
HI,WMS8,MS61,6,1,1255,1,M,0,NA,NA,NO,756,381,375,20140917,20141029,MS,2,0,21,2461,0,29,3514,0,8,1053,0,8,1053,LO
HI,WMS8,MS61,6,1,1255,3,N,0,NA,NA,NO,756,381,375,20140917,20141029,MS,2,0,21,2461,0,29,3514,0,8,1053,0,8,1053,LO
HI,WMS8,BB43,18,3,1738,2,F,0,NA,NA,NO,779,381,398,20140917,20141104,BB,2,0,21,2461,0,25,4157,0,4,1696,0,4,1696,LO
LO,WBB1,BB1,5,1,1154,2,N,1,0,10,YES,295,295,0,20140822,20141008,BB,1,56,3,1825,56,3,1825,0,0,0,0,0,0,LO
LO,WBB1,BB1,5,1,1154,1,M,1,0,10,YES,295,295,0,20140822,20141008,BB,1,56,3,1825,56,3,1825,0,0,0,0,0,0,LO
LO,WBB36,MS119,11,2,1418,1,M,1,0,10,NO,191,286,-95,20141008,20141217,MS,4,58,9,1958,39,14,2301,19,5,343,-19,5,343,LO
LO,WBB36,MS119,11,2,1418,3,F,1,0,10,NO,191,286,-95,20141008,20141217,MS,4,58,9,1958,39,14,2301,19,5,343,-19,5,343,LO
LO,WBB36,BB36,12,1,1200,1,M,1,0,10,YES,286,286,0,20140917,20141126,BB,3,58,9,1958,58,9,1958,0,0,0,0,0,0,LO
LO,WBB1,BB1,5,1,1154,3,F,1,0,10,YES,295,295,0,20140822,20141008,BB,1,56,3,1825,56,3,1825,0,0,0,0,0,0,LO
LO,WMS32,MS32,18,2,1537,3,N,1,0,10,YES,193,193,0,20140917,20141104,MS,2,54,3,1135,54,3,1135,0,0,0,0,0,0,LO
LO,WMS119,MS119,16,3,1651,1,F,1,1,7,YES,191,191,0,20141008,20141217,MS,4,39,14,2301,39,14,2301,0,0,0,0,0,0,LO
LO,WMS119,MS119,16,3,1651,3,M,1,0,10,YES,191,191,0,20141008,20141217,MS,4,39,14,2301,39,14,2301,0,0,0,0,0,0,LO
LO,WMS119,BB52,4,2,1409,3,M,1,0,10,NO,202,191,11,20140917,20141217,BB,4,39,14,2301,37,10,1225,2,4,1076,-2,-4,-1076,LO
LO,WMS119,MS119,16,3,1651,2,N,1,0,10,YES,191,191,0,20141008,20141217,MS,4,39,14,2301,39,14,2301,0,0,0,0,0,0,LO
LO,WMS119,BB52,4,2,1409,1,F,1,0,10,NO,202,191,11,20140917,20141217,BB,4,39,14,2301,37,10,1225,2,4,1076,-2,-4,-1076,LO
LO,WBB11,BB12,6,1,1155,1,M,1,1,3,NO,250,559,-309,20140822,20141022,BB,1,0,49,2569,40,12,1789,40,37,780,40,-37,-780,HI
LO,WMS119,MS24,15,1,1206,3,M,0,NA,NA,NO,291,191,100,20140821,20141119,MS,3,39,14,2301,41,14,2828,2,0,527,2,0,527,LO
LO,WBB11,BB12,6,1,1155,3,N,1,1,6,NO,250,559,-309,20140822,20141022,BB,1,0,49,2569,40,12,1789,40,37,780,40,-37,-780,HI
LO,WBB11,BB12,6,1,1155,2,F,0,NA,NA,NO,250,559,-309,20140822,20141022,BB,1,0,49,2569,40,12,1789,40,37,780,40,-37,-780,HI
LO,WBB49,BB16,3,2,1427,2,F,1,0,10,NO,315,786,-471,20140822,20141008,BB,1,0,18,7098,26,13,2331,26,5,4767,26,-5,-4767,HI
LO,WMS12,BB36,20,3,1659,3,N,0,NA,NA,NO,286,267,19,20140917,20141126,BB,3,65,8,1809,58,9,1958,7,1,149,-7,1,149,LO
LO,WBB12,BB12,14,3,1721,1,N,1,0,10,YES,250,250,0,20140822,20141022,BB,1,40,12,1789,40,12,1789,0,0,0,0,0,0,LO
LO,WBB49,BB16,3,2,1427,1,N,1,0,10,NO,315,786,-471,20140822,20141008,BB,1,0,18,7098,26,13,2331,26,5,4767,26,-5,-4767,HI
LO,WMS12,MS12,20,2,1432,1,M,0,NA,NA,YES,267,267,0,20140822,20141119,MS,3,65,8,1809,65,8,1809,0,0,0,0,0,0,LO
LO,WBB12,BB12,14,3,1721,3,F,1,0,10,YES,250,250,0,20140822,20141022,BB,1,40,12,1789,40,12,1789,0,0,0,0,0,0,LO
LO,WBB21,BB22,18,3,1730,2,F,1,0,10,NO,244,914,-670,20140822,20141112,BB,1,0,28,4403,58,8,2134,58,20,2269,58,-20,-2269,HI
LO,WBB50,MS103,15,2,1425,2,F,0,NA,NA,NO,250,193,57,20141008,20141224,MS,4,57,10,1635,35,12,1716,22,2,81,-22,2,81,LO
LO,WBB50,BB50,20,1,1215,3,N,1,1,5,YES,193,193,0,20140917,20141210,BB,4,57,10,1635,57,10,1635,0,0,0,0,0,0,LO
LO,WBB50,BB50,20,1,1215,2,M,0,NA,NA,YES,193,193,0,20140917,20141210,BB,4,57,10,1635,57,10,1635,0,0,0,0,0,0,LO
LO,WBB12,BB12,14,3,1721,2,M,1,1,2,YES,250,250,0,20140822,20141022,BB,1,40,12,1789,40,12,1789,0,0,0,0,0,0,LO
LO,WBB50,MS103,15,2,1425,3,M,0,NA,NA,NO,250,193,57,20141008,20141224,MS,4,57,10,1635,35,12,1716,22,2,81,-22,2,81,LO
LO,WBB50,BB50,20,1,1215,1,F,0,NA,NA,YES,193,193,0,20140917,20141210,BB,4,57,10,1635,57,10,1635,0,0,0,0,0,0,LO
LO,WMS14,BB1,6,3,1702,1,M,0,NA,NA,NO,295,339,-44,20140822,20141008,BB,1,1,24,3535,56,3,1825,55,21,1710,55,-21,-1710,LO
LO,WMS14,MS14,15,2,1452,1,N,0,NA,NA,YES,339,339,0,20140821,20141012,MS,1,1,24,3535,1,24,3535,0,0,0,0,0,0,LO
LO,WBB50,MS103,15,2,1425,1,N,0,NA,NA,NO,250,193,57,20141008,20141224,MS,4,57,10,1635,35,12,1716,22,2,81,-22,2,81,LO
LO,WBB33,MS38,16,2,1534,3,M,0,NA,NA,NO,498,892,-394,20140917,20141104,MS,2,0,42,6525,0,31,4440,0,11,2085,0,-11,-2085,HI
LO,WMS14,MS14,15,2,1452,2,F,0,NA,NA,YES,339,339,0,20140821,20141012,MS,1,1,24,3535,1,24,3535,0,0,0,0,0,0,LO
LO,WBB52,BB52,17,1,1208,2,N,1,0,10,YES,202,202,0,20140917,20141217,BB,4,37,10,1225,37,10,1225,0,0,0,0,0,0,LO
LO,WBB52,MS58,12,2,1419,3,N,1,0,10,NO,319,202,117,20140917,20141210,MS,4,37,10,1225,32,5,1799,5,5,574,-5,-5,574,LO
LO,WBB14,BB14,3,3,1715,1,N,1,0,10,YES,333,333,0,20140822,20141112,BB,2,47,15,2670,47,15,2670,0,0,0,0,0,0,LO
LO,WBB14,BB3,5,2,1513,2,N,1,1,2,NO,319,333,-14,20140822,20141104,BB,2,47,15,2670,34,19,4167,13,4,1497,-13,4,1497,LO
LO,WBB14,BB3,5,2,1513,1,M,1,1,5,NO,319,333,-14,20140822,20141104,BB,2,47,15,2670,34,19,4167,13,4,1497,-13,4,1497,LO
LO,WBB14,BB14,3,3,1715,3,M,1,0,10,YES,333,333,0,20140822,20141112,BB,2,47,15,2670,47,15,2670,0,0,0,0,0,0,LO
LO,WBB14,BB14,3,3,1715,2,F,1,0,10,YES,333,333,0,20140822,20141112,BB,2,47,15,2670,47,15,2670,0,0,0,0,0,0,LO
LO,WBB14,BB30,1,1,1247,1,F,0,NA,NA,NO,261,333,-72,20140917,20141112,BB,2,47,15,2670,37,8,2893,10,7,223,-10,-7,223,LO
LO,WBB14,BB30,1,1,1247,3,N,1,0,10,NO,261,333,-72,20140917,20141112,BB,2,47,15,2670,37,8,2893,10,7,223,-10,-7,223,LO
LO,WBB14,BB30,1,1,1247,2,M,0,NA,NA,NO,261,333,-72,20140917,20141112,BB,2,47,15,2670,37,8,2893,10,7,223,-10,-7,223,LO
LO,WBB14,BB3,5,2,1513,3,F,0,NA,NA,NO,319,333,-14,20140822,20141104,BB,2,47,15,2670,34,19,4167,13,4,1497,-13,4,1497,LO
LO,WBB16,BB58,12,1,1205,2,F,0,NA,NA,NO,356,315,41,20140917,20141022,BB,1,26,13,2331,9,25,2683,17,12,352,-17,12,352,LO
LO,WBB16,BB16,10,3,1712,1,F,1,1,10,YES,315,315,0,20140822,20141008,BB,1,26,13,2331,26,13,2331,0,0,0,0,0,0,LO
LO,WMS18,BB36,21,2,1434,2,F,1,0,10,NO,286,139,147,20140917,20141126,BB,3,42,11,731,58,9,1958,16,2,1227,16,-2,1227,LO
LO,WBB16,BB16,10,3,1712,3,M,1,0,10,YES,315,315,0,20140822,20141008,BB,1,26,13,2331,26,13,2331,0,0,0,0,0,0,LO
LO,WMS18,MS18,19,3,1656,2,M,0,NA,NA,YES,139,139,0,20140821,20141224,MS,4,42,11,731,42,11,731,0,0,0,0,0,0,LO
LO,WMS40,BB50,2,3,1628,1,F,0,NA,NA,NO,193,243,-50,20140917,20141210,BB,4,47,8,2277,57,10,1635,10,2,642,10,2,-642,LO
LO,WBB16,BB58,12,1,1205,3,N,1,1,10,NO,356,315,41,20140917,20141022,BB,1,26,13,2331,9,25,2683,17,12,352,-17,12,352,LO
LO,WBB16,BB58,12,1,1205,1,M,0,NA,NA,NO,356,315,41,20140917,20141022,BB,1,26,13,2331,9,25,2683,17,12,352,-17,12,352,LO
LO,WBB16,BB16,10,3,1712,2,N,1,0,10,YES,315,315,0,20140822,20141008,BB,1,26,13,2331,26,13,2331,0,0,0,0,0,0,LO
LO,WMS41,BB3,10,3,1725,1,F,1,1,9,NO,319,878,-559,20140822,20141104,BB,2,0,21,5575,34,19,4167,34,2,1408,34,-2,-1408,HI
LO,WMS41,BB3,10,3,1725,2,N,0,NA,NA,NO,319,878,-559,20140822,20141104,BB,2,0,21,5575,34,19,4167,34,2,1408,34,-2,-1408,HI
LO,WBB30,MS8,12,3,1728,3,N,0,NA,NA,NO,381,261,120,20140821,20141029,MS,2,37,8,2893,0,21,2461,37,13,432,-37,13,-432,LO
LO,WMS8,BB14,12,2,1526,1,M,1,0,10,NO,333,381,-48,20140822,20141112,BB,2,0,21,2461,47,15,2670,47,6,209,47,-6,209,LO
LO,WMS19,MS46,7,1,1158,3,F,1,1,7,NO,276,805,-529,20140917,20141022,MS,1,0,28,6634,38,34,2476,38,6,4158,38,6,-4158,HI
LO,WMS103,MS103,15,3,1650,1,N,1,0,10,YES,250,250,0,20141008,20141224,MS,4,35,12,1716,35,12,1716,0,0,0,0,0,0,LO
LO,WBB21,BB22,18,3,1730,1,M,1,0,10,NO,244,914,-670,20140822,20141112,BB,1,0,28,4403,58,8,2134,58,20,2269,58,-20,-2269,HI
LO,WBB21,BB22,18,3,1730,3,N,1,0,10,NO,244,914,-670,20140822,20141112,BB,1,0,28,4403,58,8,2134,58,20,2269,58,-20,-2269,HI
LO,WMS47,BB1,12,2,1444,1,M,1,0,10,NO,295,861,-566,20140822,20141008,BB,1,0,62,9466,56,3,1825,56,59,7641,56,-59,-7641,HI
LO,WBB22,BB22,9,1,1201,3,M,1,0,10,YES,244,244,0,20140822,20141112,BB,1,58,8,2134,58,8,2134,0,0,0,0,0,0,LO
LO,WBB22,MS46,21,2,1505,1,F,0,NA,NA,NO,276,244,32,20140917,20141022,MS,1,58,8,2134,38,34,2476,20,26,342,-20,26,342,LO
LO,WBB22,BB22,9,1,1201,2,F,1,0,10,YES,244,244,0,20140822,20141112,BB,1,58,8,2134,58,8,2134,0,0,0,0,0,0,LO
LO,WBB22,BB58,5,3,1701,3,F,0,NA,NA,NO,356,244,112,20140917,20141022,BB,1,58,8,2134,9,25,2683,49,17,549,-49,17,549,LO
LO,WBB22,BB22,9,1,1201,1,N,1,0,10,YES,244,244,0,20140822,20141112,BB,1,58,8,2134,58,8,2134,0,0,0,0,0,0,LO
LO,WBB22,MS46,21,2,1505,2,N,0,NA,NA,NO,276,244,32,20140917,20141022,MS,1,58,8,2134,38,34,2476,20,26,342,-20,26,342,LO
LO,WBB22,BB58,5,3,1701,2,N,1,0,10,NO,356,244,112,20140917,20141022,BB,1,58,8,2134,9,25,2683,49,17,549,-49,17,549,LO
LO,WBB22,BB58,5,3,1701,1,M,0,NA,NA,NO,356,244,112,20140917,20141022,BB,1,58,8,2134,9,25,2683,49,17,549,-49,17,549,LO
LO,WBB22,MS46,21,2,1505,3,M,0,NA,NA,NO,276,244,32,20140917,20141022,MS,1,58,8,2134,38,34,2476,20,26,342,-20,26,342,LO
LO,WMS38,MS38,12,1,1306,2,F,0,NA,NA,YES,498,498,0,20140917,20141104,MS,2,0,31,4440,0,31,4440,0,0,0,0,0,0,LO
LO,WBB59,MS50,7,3,1637,1,N,1,0,10,NO,264,1007,-743,20140917,20141217,MS,4,0,24,7336,22,15,1873,22,9,5463,22,-9,-5463,HI
LO,WBB59,BB50,17,2,1427,2,N,1,0,10,NO,193,1007,-814,20140917,20141210,BB,4,0,24,7336,57,10,1635,57,14,5701,57,-14,-5701,HI
LO,WBB59,MS50,7,3,1637,3,F,1,0,10,NO,264,1007,-743,20140917,20141217,MS,4,0,24,7336,22,15,1873,22,9,5463,22,-9,-5463,HI
LO,WBB59,BB50,17,2,1427,1,M,0,NA,NA,NO,193,1007,-814,20140917,20141210,BB,4,0,24,7336,57,10,1635,57,14,5701,57,-14,-5701,HI
LO,WBB36,MS70,3,3,1629,3,M,0,NA,NA,NO,281,286,-5,20140917,20141224,MS,4,58,9,1958,35,10,2724,23,1,766,-23,1,766,LO
LO,WBB9,MS22,14,2,1450,1,F,0,NA,NA,NO,258,579,-321,20140821,20141112,MS,1,0,24,3913,40,9,1362,40,15,2551,40,-15,-2551,HI
LO,WBB36,MS70,3,3,1629,1,N,1,0,10,NO,281,286,-5,20140917,20141224,MS,4,58,9,1958,35,10,2724,23,1,766,-23,1,766,LO
LO,WBB9,MS22,14,2,1450,2,M,1,1,2,NO,258,579,-321,20140821,20141112,MS,1,0,24,3913,40,9,1362,40,15,2551,40,-15,-2551,HI
LO,WBB3,MS32,5,3,1717,2,N,1,1,9,NO,193,319,-126,20140917,20141104,MS,2,34,19,4167,54,3,1135,20,16,3032,20,-16,-3032,LO
LO,WBB9,MS22,14,2,1450,3,N,1,0,10,NO,258,579,-321,20140821,20141112,MS,1,0,24,3913,40,9,1362,40,15,2551,40,-15,-2551,HI
LO,WBB3,BB3,17,1,1316,3,F,1,1,3,YES,319,319,0,20140822,20141104,BB,2,34,19,4167,34,19,4167,0,0,0,0,0,0,LO
LO,WBB3,BB3,17,1,1316,2,N,1,1,8,YES,319,319,0,20140822,20141104,BB,2,34,19,4167,34,19,4167,0,0,0,0,0,0,LO
LO,WBB3,MS32,5,3,1717,1,M,1,1,8,NO,193,319,-126,20140917,20141104,MS,2,34,19,4167,54,3,1135,20,16,3032,20,-16,-3032,LO
LO,WBB3,BB3,17,1,1316,1,M,1,1,4,YES,319,319,0,20140822,20141104,BB,2,34,19,4167,34,19,4167,0,0,0,0,0,0,LO
LO,WBB3,MS32,5,3,1717,3,F,1,0,10,NO,193,319,-126,20140917,20141104,MS,2,34,19,4167,54,3,1135,20,16,3032,20,-16,-3032,LO
LO,WMS10,MS10,15,2,1533,3,M,1,0,10,YES,181,181,0,20140821,20141104,MS,2,61,5,1576,61,5,1576,0,0,0,0,0,0,LO
LO,WMS10,MS10,15,2,1533,1,N,1,0,10,YES,181,181,0,20140821,20141104,MS,2,61,5,1576,61,5,1576,0,0,0,0,0,0,LO
LO,WBB30,MS32,18,1,1317,2,N,1,1,9,NO,193,261,-68,20140917,20141104,MS,2,37,8,2893,54,3,1135,17,5,1758,17,-5,-1758,LO
LO,WBB30,MS32,18,1,1317,3,F,1,0,10,NO,193,261,-68,20140917,20141104,MS,2,37,8,2893,54,3,1135,17,5,1758,17,-5,-1758,LO
LO,WBB30,MS32,18,1,1317,1,M,1,0,10,NO,193,261,-68,20140917,20141104,MS,2,37,8,2893,54,3,1135,17,5,1758,17,-5,-1758,LO
LO,WBB30,BB30,7,2,1519,3,N,1,1,5,YES,261,261,0,20140917,20141112,BB,2,37,8,2893,37,8,2893,0,0,0,0,0,0,LO
LO,WBB30,MS8,12,3,1728,1,M,0,NA,NA,NO,381,261,120,20140821,20141029,MS,2,37,8,2893,0,21,2461,37,13,432,-37,13,-432,LO
LO,WBB30,BB30,7,2,1519,1,F,0,NA,NA,YES,261,261,0,20140917,20141112,BB,2,37,8,2893,37,8,2893,0,0,0,0,0,0,LO
LO,WBB49,BB16,3,2,1427,3,M,1,0,10,NO,315,786,-471,20140822,20141008,BB,1,0,18,7098,26,13,2331,26,5,4767,26,-5,-4767,HI
LO,WBB30,BB30,7,2,1519,2,M,1,0,10,YES,261,261,0,20140917,20141112,BB,2,37,8,2893,37,8,2893,0,0,0,0,0,0,LO
LO,WBB30,MS8,12,3,1728,2,F,0,NA,NA,NO,381,261,120,20140821,20141029,MS,2,37,8,2893,0,21,2461,37,13,432,-37,13,-432,LO
LO,WMS12,BB36,20,3,1659,2,M,0,NA,NA,NO,286,267,19,20140917,20141126,BB,3,65,8,1809,58,9,1958,7,1,149,-7,1,149,LO
LO,WBB31,MS28,2,2,1510,1,N,1,0,10,NO,328,796,-468,20140821,20141112,MS,2,6,11,3338,45,9,2278,39,2,1060,39,-2,-1060,HI
LO,WMS47,BB1,12,2,1444,3,N,1,0,10,NO,295,861,-566,20140822,20141008,BB,1,0,62,9466,56,3,1825,56,59,7641,56,-59,-7641,HI
LO,WMS20,MS20,13,3,1648,2,M,1,0,10,YES,224,224,0,20140821,20141126,MS,3,27,11,1915,27,11,1915,0,0,0,0,0,0,LO
LO,WMS104,MS64,1,2,1405,3,F,1,0,10,NO,316,511,-195,20140917,20141217,MS,4,0,3,1366,26,15,1598,26,12,232,26,12,232,HI
LO,WMS104,MS111,8,3,1638,1,F,1,0,10,NO,196,511,-315,20141008,20141224,MS,4,0,3,1366,61,0,1417,61,3,51,61,-3,51,HI
LO,WBB31,MS28,2,2,1510,2,M,1,0,10,NO,328,796,-468,20140821,20141112,MS,2,6,11,3338,45,9,2278,39,2,1060,39,-2,-1060,HI
LO,WMS104,MS64,1,2,1405,2,M,1,0,10,NO,316,511,-195,20140917,20141217,MS,4,0,3,1366,26,15,1598,26,12,232,26,12,232,HI
LO,WBB31,MS28,2,2,1510,3,F,1,0,10,NO,328,796,-468,20140821,20141112,MS,2,6,11,3338,45,9,2278,39,2,1060,39,-2,-1060,HI
LO,WMS104,MS111,8,3,1638,3,N,1,0,10,NO,196,511,-315,20141008,20141224,MS,4,0,3,1366,61,0,1417,61,3,51,61,-3,51,HI
LO,WMS104,MS111,8,3,1638,2,M,1,0,10,NO,196,511,-315,20141008,20141224,MS,4,0,3,1366,61,0,1417,61,3,51,61,-3,51,HI
LO,WMS111,MS103,16,1,1207,1,N,1,0,10,NO,250,196,54,20141008,20141224,MS,4,61,0,1417,35,12,1716,26,12,299,-26,12,299,LO
LO,WMS111,MS111,18,2,1428,2,F,1,0,10,YES,196,196,0,20141008,20141224,MS,4,61,0,1417,61,0,1417,0,0,0,0,0,0,LO
LO,WMS42,MS42,6,2,1411,3,N,1,0,10,YES,201,201,0,20140917,20141126,MS,3,36,10,1140,36,10,1140,0,0,0,0,0,0,LO
LO,WMS111,MS111,18,2,1428,1,M,1,0,10,YES,196,196,0,20141008,20141224,MS,4,61,0,1417,61,0,1417,0,0,0,0,0,0,LO
LO,WBB33,MS38,16,2,1534,2,N,0,NA,NA,NO,498,892,-394,20140917,20141104,MS,2,0,42,6525,0,31,4440,0,11,2085,0,-11,-2085,HI
LO,WBB33,MS38,16,2,1534,1,F,0,NA,NA,NO,498,892,-394,20140917,20141104,MS,2,0,42,6525,0,31,4440,0,11,2085,0,-11,-2085,HI
LO,WMS111,MS103,16,1,1207,2,F,1,1,9,NO,250,196,54,20141008,20141224,MS,4,61,0,1417,35,12,1716,26,12,299,-26,12,299,LO
LO,WBB52,BB52,17,1,1208,1,M,1,0,10,YES,202,202,0,20140917,20141217,BB,4,37,10,1225,37,10,1225,0,0,0,0,0,0,LO
LO,WBB36,MS119,11,2,1418,2,N,1,0,10,NO,191,286,-95,20141008,20141217,MS,4,58,9,1958,39,14,2301,19,5,343,-19,5,343,LO
LO,WMS69,MS42,1,1,1142,2,M,1,0,10,NO,201,787,-586,20140917,20141126,MS,3,0,11,2748,36,10,1140,36,1,1608,36,-1,-1608,HI
LO,WBB36,BB36,12,1,1200,2,F,1,0,10,YES,286,286,0,20140917,20141126,BB,3,58,9,1958,58,9,1958,0,0,0,0,0,0,LO
LO,WBB36,BB36,12,1,1200,3,N,1,0,10,YES,286,286,0,20140917,20141126,BB,3,58,9,1958,58,9,1958,0,0,0,0,0,0,LO
LO,WBB36,MS70,3,3,1629,2,F,0,NA,NA,NO,281,286,-5,20140917,20141224,MS,4,58,9,1958,35,10,2724,23,1,766,-23,1,766,LO
LO,WMS28,MS28,10,1,1303,2,N,1,1,1,YES,328,328,0,20140821,20141112,MS,2,45,9,2278,45,9,2278,0,0,0,0,0,0,LO
LO,WMS112,MS12,5,1,1149,3,M,0,NA,NA,NO,267,552,-285,20140822,20141119,MS,3,0,36,3959,65,8,1809,65,28,2150,65,-28,-2150,HI
LO,WMS112,MS42,1,3,1627,2,M,1,0,10,NO,201,552,-351,20140917,20141126,MS,3,0,36,3959,36,10,1140,36,26,2819,36,-26,-2819,HI
LO,WMS112,MS12,5,1,1149,1,N,1,0,10,NO,267,552,-285,20140822,20141119,MS,3,0,36,3959,65,8,1809,65,28,2150,65,-28,-2150,HI
LO,WMS58,MS20,18,1,1210,1,M,1,0,10,NO,224,319,-95,20140821,20141126,MS,3,32,5,1799,27,11,1915,5,6,116,-5,6,116,LO
LO,WMS32,MS8,13,1,1308,1,F,0,NA,NA,NO,381,193,188,20140821,20141029,MS,2,54,3,1135,0,21,2461,54,18,1326,-54,18,1326,LO
LO,WMS32,MS8,13,1,1308,2,M,0,NA,NA,NO,381,193,188,20140821,20141029,MS,2,54,3,1135,0,21,2461,54,18,1326,-54,18,1326,LO
LO,WMS32,MS10,19,3,1739,1,N,1,0,10,NO,181,193,-12,20140821,20141104,MS,2,54,3,1135,61,5,1576,7,2,441,7,2,441,LO
LO,WMS32,MS32,18,2,1537,2,F,1,0,10,YES,193,193,0,20140917,20141104,MS,2,54,3,1135,54,3,1135,0,0,0,0,0,0,LO
LO,WMS32,MS8,13,1,1308,3,N,0,NA,NA,NO,381,193,188,20140821,20141029,MS,2,54,3,1135,0,21,2461,54,18,1326,-54,18,1326,LO
LO,WMS119,MS24,15,1,1206,1,F,1,1,10,NO,291,191,100,20140821,20141119,MS,3,39,14,2301,41,14,2828,2,0,527,2,0,527,LO
LO,WMS19,MS46,7,1,1158,2,M,0,NA,NA,NO,276,805,-529,20140917,20141022,MS,1,0,28,6634,38,34,2476,38,6,4158,38,6,-4158,HI
LO,WMS119,BB52,4,2,1409,2,N,1,0,10,NO,202,191,11,20140917,20141217,BB,4,39,14,2301,37,10,1225,2,4,1076,-2,-4,-1076,LO
LO,WMS103,MS26,8,2,1415,1,F,1,0,10,NO,220,250,-30,20140821,20141119,MS,3,35,12,1716,35,6,1485,0,6,231,0,-6,-231,LO
LO,WMS12,BB36,20,3,1659,1,F,0,NA,NA,NO,286,267,19,20140917,20141126,BB,3,65,8,1809,58,9,1958,7,1,149,-7,1,149,LO
LO,WMS103,MS26,8,2,1415,3,N,1,0,10,NO,220,250,-30,20140821,20141119,MS,3,35,12,1716,35,6,1485,0,6,231,0,-6,-231,LO
LO,WMS41,BB3,10,3,1725,3,M,0,NA,NA,NO,319,878,-559,20140822,20141104,BB,2,0,21,5575,34,19,4167,34,2,1408,34,-2,-1408,HI
LO,WMS12,MS12,20,2,1432,2,N,0,NA,NA,YES,267,267,0,20140822,20141119,MS,3,65,8,1809,65,8,1809,0,0,0,0,0,0,LO
LO,WBB58,BB58,18,2,1456,3,F,0,NA,NA,YES,356,356,0,20140917,20141022,BB,1,9,25,2683,9,25,2683,0,0,0,0,0,0,LO
LO,WMS17,MS14,20,3,1735,1,N,0,NA,NA,NO,339,802,-463,20140821,20141012,MS,1,0,24,5481,1,24,3535,1,0,1946,1,0,-1946,HI
LO,WBB58,BB58,18,2,1456,2,N,0,NA,NA,YES,356,356,0,20140917,20141022,BB,1,9,25,2683,9,25,2683,0,0,0,0,0,0,LO
LO,WMS20,MS24,3,2,1407,2,F,0,NA,NA,NO,291,224,67,20140821,20141119,MS,3,27,11,1915,41,14,2828,14,3,913,14,3,913,LO
LO,WMS12,MS12,20,2,1432,3,F,0,NA,NA,YES,267,267,0,20140822,20141119,MS,3,65,8,1809,65,8,1809,0,0,0,0,0,0,LO
LO,WMS14,BB1,6,3,1702,2,F,1,0,10,NO,295,339,-44,20140822,20141008,BB,1,1,24,3535,56,3,1825,55,21,1710,55,-21,-1710,LO
LO,WMS14,BB1,6,3,1702,3,N,0,NA,NA,NO,295,339,-44,20140822,20141008,BB,1,1,24,3535,56,3,1825,55,21,1710,55,-21,-1710,LO
LO,WMS14,MS14,15,2,1452,3,M,0,NA,NA,YES,339,339,0,20140821,20141012,MS,1,1,24,3535,1,24,3535,0,0,0,0,0,0,LO
LO,WBB59,BB50,17,2,1427,3,F,0,NA,NA,NO,193,1007,-814,20140917,20141210,BB,4,0,24,7336,57,10,1635,57,14,5701,57,-14,-5701,HI
LO,WMS64,MS50,3,1,1146,1,M,1,0,10,NO,264,316,-52,20140917,20141217,MS,4,26,15,1598,22,15,1873,4,0,275,-4,0,275,LO
LO,WMS38,MS38,12,1,1306,1,M,0,NA,NA,YES,498,498,0,20140917,20141104,MS,2,0,31,4440,0,31,4440,0,0,0,0,0,0,LO
LO,WMS26,MS26,22,3,1702,2,N,1,1,7,YES,220,220,0,20140821,20141119,MS,3,35,6,1485,35,6,1485,0,0,0,0,0,0,LO
LO,WMS111,MS12,5,3,1632,1,M,0,NA,NA,NO,267,196,71,20140822,20141119,MS,3,61,0,1417,65,8,1809,4,8,392,4,8,392,LO
LO,WMS38,MS38,12,1,1306,3,N,1,0,10,YES,498,498,0,20140917,20141104,MS,2,0,31,4440,0,31,4440,0,0,0,0,0,0,LO
LO,WMS40,MS18,9,2,1416,1,F,0,NA,NA,NO,139,243,-104,20140821,20141224,MS,4,47,8,2277,42,11,731,5,3,1546,-5,3,-1546,LO
LO,WMS21,BB16,10,1,1202,2,N,1,0,10,NO,315,885,-570,20140822,20141008,BB,1,0,13,6104,26,13,2331,26,0,3773,26,0,-3773,HI
LO,WMS43,MS28,17,3,1737,1,M,0,NA,NA,NO,328,749,-421,20140821,20141112,MS,2,0,3,4004,45,9,2278,45,6,1726,45,6,-1726,HI
LO,WBB52,MS58,12,2,1419,1,M,1,0,10,NO,319,202,117,20140917,20141210,MS,4,37,10,1225,32,5,1799,5,5,574,-5,-5,574,LO
LO,WMS21,BB16,10,1,1202,1,F,1,1,10,NO,315,885,-570,20140822,20141008,BB,1,0,13,6104,26,13,2331,26,0,3773,26,0,-3773,HI
LO,WBB52,MS58,12,2,1419,2,F,1,0,10,NO,319,202,117,20140917,20141210,MS,4,37,10,1225,32,5,1799,5,5,574,-5,-5,574,LO
LO,WBB52,BB52,17,1,1208,3,F,1,0,10,YES,202,202,0,20140917,20141217,BB,4,37,10,1225,37,10,1225,0,0,0,0,0,0,LO
LO,WMS39,MS14,8,1,1159,2,M,0,NA,NA,NO,339,765,-426,20140821,20141012,MS,1,0,31,6885,1,24,3535,1,7,3350,1,-7,-3350,HI
LO,WMS69,MS42,1,1,1142,1,N,1,0,10,NO,201,787,-586,20140917,20141126,MS,3,0,11,2748,36,10,1140,36,1,1608,36,-1,-1608,HI
LO,WMS18,MS18,19,3,1656,1,N,0,NA,NA,YES,139,139,0,20140821,20141224,MS,4,42,11,731,42,11,731,0,0,0,0,0,0,LO
LO,WMS18,BB36,21,2,1434,3,N,1,0,10,NO,286,139,147,20140917,20141126,BB,3,42,11,731,58,9,1958,16,2,1227,16,-2,1227,LO
LO,WMS18,MS18,19,3,1656,3,F,0,NA,NA,YES,139,139,0,20140821,20141224,MS,4,42,11,731,42,11,731,0,0,0,0,0,0,LO
LO,WMS40,MS40,8,1,1155,1,F,1,0,10,YES,243,243,0,20140917,20141126,MS,3,47,8,2277,47,8,2277,0,0,0,0,0,0,LO
LO,WMS103,MS103,15,3,1650,3,M,1,0,10,YES,250,250,0,20141008,20141224,MS,4,35,12,1716,35,12,1716,0,0,0,0,0,0,LO
LO,WMS18,BB36,21,2,1434,1,M,1,0,10,NO,286,139,147,20140917,20141126,BB,3,42,11,731,58,9,1958,16,2,1227,16,-2,1227,LO
LO,WMS40,MS40,8,1,1155,3,N,1,0,10,YES,243,243,0,20140917,20141126,MS,3,47,8,2277,47,8,2277,0,0,0,0,0,0,LO
LO,WMS10,MS10,15,2,1533,2,F,1,0,10,YES,181,181,0,20140821,20141104,MS,2,61,5,1576,61,5,1576,0,0,0,0,0,0,LO
LO,WMS40,MS18,9,2,1416,3,M,0,NA,NA,NO,139,243,-104,20140821,20141224,MS,4,47,8,2277,42,11,731,5,3,1546,-5,3,-1546,LO
LO,WMS19,MS46,7,1,1158,1,N,0,NA,NA,NO,276,805,-529,20140917,20141022,MS,1,0,28,6634,38,34,2476,38,6,4158,38,6,-4158,HI
LO,WMS103,MS103,15,3,1650,2,F,1,1,2,YES,250,250,0,20141008,20141224,MS,4,35,12,1716,35,12,1716,0,0,0,0,0,0,LO
LO,WMS8,BB14,12,2,1526,2,F,1,0,10,NO,333,381,-48,20140822,20141112,BB,2,0,21,2461,47,15,2670,47,6,209,47,-6,209,LO
LO,WMS24,MS24,10,3,1641,2,F,1,1,5,YES,291,291,0,20140821,20141119,MS,3,41,14,2828,41,14,2828,0,0,0,0,0,0,LO
LO,WMS103,MS26,8,2,1415,2,M,1,1,2,NO,220,250,-30,20140821,20141119,MS,3,35,12,1716,35,6,1485,0,6,231,0,-6,-231,LO
LO,WMS24,MS44,16,2,1426,1,F,0,NA,NA,NO,199,291,-92,20140917,20141119,MS,3,41,14,2828,53,9,2263,12,5,565,12,-5,-565,LO
LO,WMS103,MS119,14,1,1205,3,N,1,1,1,NO,191,250,-59,20141008,20141217,MS,4,35,12,1716,39,14,2301,4,2,585,4,2,585,LO
LO,WMS47,MS22,17,3,1728,2,N,1,0,10,NO,258,861,-603,20140821,20141112,MS,1,0,62,9466,40,9,1362,40,53,8104,40,-53,-8104,HI
LO,WMS43,MS28,17,3,1737,2,N,1,1,4,NO,328,749,-421,20140821,20141112,MS,2,0,3,4004,45,9,2278,45,6,1726,45,6,-1726,HI
LO,WMS21,BB16,10,1,1202,3,M,1,0,10,NO,315,885,-570,20140822,20141008,BB,1,0,13,6104,26,13,2331,26,0,3773,26,0,-3773,HI
LO,WMS111,MS12,5,3,1632,3,F,0,NA,NA,NO,267,196,71,20140822,20141119,MS,3,61,0,1417,65,8,1809,4,8,392,4,8,392,LO
LO,WMS47,MS22,17,3,1728,3,F,0,NA,NA,NO,258,861,-603,20140821,20141112,MS,1,0,62,9466,40,9,1362,40,53,8104,40,-53,-8104,HI
LO,WMS20,MS20,13,3,1648,3,F,1,0,10,YES,224,224,0,20140821,20141126,MS,3,27,11,1915,27,11,1915,0,0,0,0,0,0,LO
LO,WMS20,MS20,13,3,1648,1,N,1,0,10,YES,224,224,0,20140821,20141126,MS,3,27,11,1915,27,11,1915,0,0,0,0,0,0,LO
LO,WBB58,BB58,18,2,1456,1,M,0,NA,NA,YES,356,356,0,20140917,20141022,BB,1,9,25,2683,9,25,2683,0,0,0,0,0,0,LO
LO,WMS20,MS26,6,1,1150,3,M,1,1,4,NO,220,224,-4,20140821,20141119,MS,3,27,11,1915,35,6,1485,8,5,430,8,-5,-430,LO
LO,WMS26,MS20,23,2,1436,1,F,1,0,10,NO,224,220,4,20140821,20141126,MS,3,35,6,1485,27,11,1915,8,5,430,-8,5,430,LO
LO,WMS20,MS26,6,1,1150,1,F,0,NA,NA,NO,220,224,-4,20140821,20141119,MS,3,27,11,1915,35,6,1485,8,5,430,8,-5,-430,LO
LO,WBB59,MS50,7,3,1637,2,M,1,0,10,NO,264,1007,-743,20140917,20141217,MS,4,0,24,7336,22,15,1873,22,9,5463,22,-9,-5463,HI
LO,WMS64,MS64,18,3,1653,3,N,1,0,10,YES,316,316,0,20140917,20141217,MS,4,26,15,1598,26,15,1598,0,0,0,0,0,0,LO
LO,WMS44,MS44,4,1,1147,3,N,1,0,10,YES,199,199,0,20140917,20141119,MS,3,53,9,2263,53,9,2263,0,0,0,0,0,0,LO
LO,WMS10,MS38,14,3,1733,1,N,0,NA,NA,NO,498,181,317,20140917,20141104,MS,2,61,5,1576,0,31,4440,61,26,2864,-61,26,2864,LO
LO,WMS10,MS38,14,3,1733,3,F,0,NA,NA,NO,498,181,317,20140917,20141104,MS,2,61,5,1576,0,31,4440,61,26,2864,-61,26,2864,LO
LO,WMS24,MS58,22,1,1217,2,F,1,0,10,NO,319,291,28,20140917,20141210,MS,4,41,14,2828,32,5,1799,9,9,1029,-9,-9,-1029,LO
LO,WMS28,BB30,2,3,1714,2,M,1,1,3,NO,261,328,-67,20140917,20141112,BB,2,45,9,2278,37,8,2893,8,1,615,-8,-1,615,LO
LO,WMS111,MS103,16,1,1207,3,M,0,NA,NA,NO,250,196,54,20141008,20141224,MS,4,61,0,1417,35,12,1716,26,12,299,-26,12,299,LO
LO,WMS111,MS111,18,2,1428,3,N,1,0,10,YES,196,196,0,20141008,20141224,MS,4,61,0,1417,61,0,1417,0,0,0,0,0,0,LO
LO,WMS28,MS28,10,1,1303,3,M,0,NA,NA,YES,328,328,0,20140821,20141112,MS,2,45,9,2278,45,9,2278,0,0,0,0,0,0,LO
LO,WMS22,MS22,19,1,1224,3,F,1,0,10,YES,258,258,0,20140821,20141112,MS,1,40,9,1362,40,9,1362,0,0,0,0,0,0,LO
LO,WMS22,MS22,19,1,1224,2,M,1,0,10,YES,258,258,0,20140821,20141112,MS,1,40,9,1362,40,9,1362,0,0,0,0,0,0,LO
LO,WMS44,MS70,7,2,1413,1,N,1,0,10,NO,281,199,82,20140917,20141224,MS,4,53,9,2263,35,10,2724,18,1,461,-18,1,461,LO
LO,WMS22,MS22,19,1,1224,1,N,1,0,10,YES,258,258,0,20140821,20141112,MS,1,40,9,1362,40,9,1362,0,0,0,0,0,0,LO
LO,WMS44,MS44,4,1,1147,1,M,1,0,10,YES,199,199,0,20140917,20141119,MS,3,53,9,2263,53,9,2263,0,0,0,0,0,0,LO
LO,WMS42,MS111,11,1,1159,2,N,1,0,10,NO,196,201,-5,20141008,20141224,MS,4,36,10,1140,61,0,1417,25,10,277,25,-10,277,LO
LO,WMS8,BB14,12,2,1526,3,N,1,0,10,NO,333,381,-48,20140822,20141112,BB,2,0,21,2461,47,15,2670,47,6,209,47,-6,209,LO
LO,WMS26,MS64,9,1,1156,1,F,0,NA,NA,NO,316,220,96,20140917,20141217,MS,4,35,6,1485,26,15,1598,9,9,113,-9,9,113,LO
LO,WMS111,MS12,5,3,1632,2,N,0,NA,NA,NO,267,196,71,20140822,20141119,MS,3,61,0,1417,65,8,1809,4,8,392,4,8,392,LO
LO,WMS24,MS24,10,3,1641,1,N,1,0,10,YES,291,291,0,20140821,20141119,MS,3,41,14,2828,41,14,2828,0,0,0,0,0,0,LO
LO,WMS59,BB14,2,1,1249,1,N,1,1,8,NO,333,909,-576,20140822,20141112,BB,2,0,28,4502,47,15,2670,47,13,1832,47,-13,-1832,HI
LO,WMS10,MS38,14,3,1733,2,M,0,NA,NA,NO,498,181,317,20140917,20141104,MS,2,61,5,1576,0,31,4440,61,26,2864,-61,26,2864,LO
LO,WMS103,MS119,14,1,1205,2,M,1,0,10,NO,191,250,-59,20141008,20141217,MS,4,35,12,1716,39,14,2301,4,2,585,4,2,585,LO
LO,WMS40,MS18,9,2,1416,2,N,1,1,7,NO,139,243,-104,20140821,20141224,MS,4,47,8,2277,42,11,731,5,3,1546,-5,3,-1546,LO
LO,WMS103,MS119,14,1,1205,1,F,1,0,10,NO,191,250,-59,20141008,20141217,MS,4,35,12,1716,39,14,2301,4,2,585,4,2,585,LO
LO,WMS64,MS64,18,3,1653,1,M,1,1,9,YES,316,316,0,20140917,20141217,MS,4,26,15,1598,26,15,1598,0,0,0,0,0,0,LO
LO,WMS119,MS24,15,1,1206,2,N,0,NA,NA,NO,291,191,100,20140821,20141119,MS,3,39,14,2301,41,14,2828,2,0,527,2,0,527,LO
LO,WMS46,BB22,16,2,1453,1,F,1,1,9,NO,244,276,-32,20140822,20141112,BB,1,38,34,2476,58,8,2134,20,26,342,20,-26,-342,LO
LO,WMS32,MS32,18,2,1537,1,M,1,0,10,YES,193,193,0,20140917,20141104,MS,2,54,3,1135,54,3,1135,0,0,0,0,0,0,LO
LO,WMS32,MS10,19,3,1739,2,F,0,NA,NA,NO,181,193,-12,20140821,20141104,MS,2,54,3,1135,61,5,1576,7,2,441,7,2,441,LO
LO,WMS32,MS10,19,3,1739,3,M,1,0,10,NO,181,193,-12,20140821,20141104,MS,2,54,3,1135,61,5,1576,7,2,441,7,2,441,LO
LO,WMS70,MS70,21,1,1216,1,M,1,1,9,YES,281,281,0,20140917,20141224,MS,4,35,10,2724,35,10,2724,0,0,0,0,0,0,LO
LO,WMS64,MS64,18,3,1653,2,F,1,1,5,YES,316,316,0,20140917,20141217,MS,4,26,15,1598,26,15,1598,0,0,0,0,0,0,LO
LO,WMS20,MS24,3,2,1407,3,M,0,NA,NA,NO,291,224,67,20140821,20141119,MS,3,27,11,1915,41,14,2828,14,3,913,14,3,913,LO
LO,WMS47,MS22,17,3,1728,1,M,1,1,8,NO,258,861,-603,20140821,20141112,MS,1,0,62,9466,40,9,1362,40,53,8104,40,-53,-8104,HI
LO,WMS50,MS50,14,2,1423,2,M,1,0,10,YES,264,264,0,20140917,20141217,MS,4,22,15,1873,22,15,1873,0,0,0,0,0,0,LO
LO,WMS26,MS20,23,2,1436,3,M,1,0,10,NO,224,220,4,20140821,20141126,MS,3,35,6,1485,27,11,1915,8,5,430,-8,5,430,LO
LO,WMS104,MS64,1,2,1405,1,N,1,1,3,NO,316,511,-195,20140917,20141217,MS,4,0,3,1366,26,15,1598,26,12,232,26,12,232,HI
LO,WMS112,MS42,1,3,1627,1,N,1,0,10,NO,201,552,-351,20140917,20141126,MS,3,0,36,3959,36,10,1140,36,26,2819,36,-26,-2819,HI
LO,WMS26,MS26,22,3,1702,1,F,1,1,9,YES,220,220,0,20140821,20141119,MS,3,35,6,1485,35,6,1485,0,0,0,0,0,0,LO
LO,WMS26,MS26,22,3,1702,3,M,1,0,10,YES,220,220,0,20140821,20141119,MS,3,35,6,1485,35,6,1485,0,0,0,0,0,0,LO
LO,WMS42,MS42,6,2,1411,2,F,1,0,10,YES,201,201,0,20140917,20141126,MS,3,36,10,1140,36,10,1140,0,0,0,0,0,0,LO
LO,WMS39,BB12,8,2,1436,2,M,0,NA,NA,NO,250,765,-515,20140822,20141022,BB,1,0,31,6885,40,12,1789,40,19,5096,40,-19,-5096,HI
LO,WMS47,BB1,12,2,1444,2,F,0,NA,NA,NO,295,861,-566,20140822,20141008,BB,1,0,62,9466,56,3,1825,56,59,7641,56,-59,-7641,HI
LO,WMS26,MS64,9,1,1156,3,M,0,NA,NA,NO,316,220,96,20140917,20141217,MS,4,35,6,1485,26,15,1598,9,9,113,-9,9,113,LO
LO,WMS58,MS58,4,3,1631,3,M,1,0,10,YES,319,319,0,20140917,20141210,MS,4,32,5,1799,32,5,1799,0,0,0,0,0,0,LO
LO,WMS28,MS8,19,2,1538,3,F,0,NA,NA,NO,381,328,53,20140821,20141029,MS,2,45,9,2278,0,21,2461,45,12,183,-45,12,183,LO
LO,WMS39,MS14,8,1,1159,1,F,0,NA,NA,NO,339,765,-426,20140821,20141012,MS,1,0,31,6885,1,24,3535,1,7,3350,1,-7,-3350,HI
LO,WMS17,MS14,20,3,1735,2,M,0,NA,NA,NO,339,802,-463,20140821,20141012,MS,1,0,24,5481,1,24,3535,1,0,1946,1,0,-1946,HI
LO,WMS28,MS8,19,2,1538,2,N,1,1,1,NO,381,328,53,20140821,20141029,MS,2,45,9,2278,0,21,2461,45,12,183,-45,12,183,LO
LO,WMS112,MS42,1,3,1627,3,F,1,0,10,NO,201,552,-351,20140917,20141126,MS,3,0,36,3959,36,10,1140,36,26,2819,36,-26,-2819,HI
LO,WMS40,BB50,2,3,1628,2,M,0,NA,NA,NO,193,243,-50,20140917,20141210,BB,4,47,8,2277,57,10,1635,10,2,642,10,2,-642,LO
LO,WMS112,MS12,5,1,1149,2,F,0,NA,NA,NO,267,552,-285,20140822,20141119,MS,3,0,36,3959,65,8,1809,65,28,2150,65,-28,-2150,HI
LO,WMS58,MS58,4,3,1631,1,F,1,1,7,YES,319,319,0,20140917,20141210,MS,4,32,5,1799,32,5,1799,0,0,0,0,0,0,LO
LO,WMS28,BB30,2,3,1714,1,N,1,1,6,NO,261,328,-67,20140917,20141112,BB,2,45,9,2278,37,8,2893,8,1,615,-8,-1,615,LO
LO,WMS69,BB52,14,3,1649,3,N,1,0,10,NO,202,787,-585,20140917,20141217,BB,4,0,11,2748,37,10,1225,37,1,1523,37,-1,-1523,HI
LO,WMS70,MS70,21,1,1216,3,F,1,0,10,YES,281,281,0,20140917,20141224,MS,4,35,10,2724,35,10,2724,0,0,0,0,0,0,LO
LO,WMS40,BB50,2,3,1628,3,N,0,NA,NA,NO,193,243,-50,20140917,20141210,BB,4,47,8,2277,57,10,1635,10,2,642,10,2,-642,LO
LO,WMS64,MS50,3,1,1146,2,N,1,0,10,NO,264,316,-52,20140917,20141217,MS,4,26,15,1598,22,15,1873,4,0,275,-4,0,275,LO
LO,WMS59,BB14,2,1,1249,3,F,0,NA,NA,NO,333,909,-576,20140822,20141112,BB,2,0,28,4502,47,15,2670,47,13,1832,47,-13,-1832,HI
LO,WMS46,MS46,1,3,1655,1,F,0,NA,NA,YES,276,276,0,20140917,20141022,MS,1,38,34,2476,38,34,2476,0,0,0,0,0,0,LO
LO,WMS24,MS24,10,3,1641,3,M,1,0,10,YES,291,291,0,20140821,20141119,MS,3,41,14,2828,41,14,2828,0,0,0,0,0,0,LO
LO,WMS59,BB14,2,1,1249,2,M,1,0,10,NO,333,909,-576,20140822,20141112,BB,2,0,28,4502,47,15,2670,47,13,1832,47,-13,-1832,HI
LO,WMS24,MS44,16,2,1426,2,N,1,0,10,NO,199,291,-92,20140917,20141119,MS,3,41,14,2828,53,9,2263,12,5,565,12,-5,-565,LO
LO,WMS64,MS50,3,1,1146,3,F,1,0,10,NO,264,316,-52,20140917,20141217,MS,4,26,15,1598,22,15,1873,4,0,275,-4,0,275,LO
LO,WMS42,MS111,11,1,1159,1,M,1,1,9,NO,196,201,-5,20141008,20141224,MS,4,36,10,1140,61,0,1417,25,10,277,25,-10,277,LO
LO,WMS24,MS58,22,1,1217,1,M,1,1,8,NO,319,291,28,20140917,20141210,MS,4,41,14,2828,32,5,1799,9,9,1029,-9,-9,-1029,LO
LO,WMS46,BB22,16,2,1453,3,M,1,0,10,NO,244,276,-32,20140822,20141112,BB,1,38,34,2476,58,8,2134,20,26,342,20,-26,-342,LO
LO,WMS39,BB12,8,2,1436,3,N,1,1,1,NO,250,765,-515,20140822,20141022,BB,1,0,31,6885,40,12,1789,40,19,5096,40,-19,-5096,HI
LO,WMS44,MS44,4,1,1147,2,F,0,NA,NA,YES,199,199,0,20140917,20141119,MS,3,53,9,2263,53,9,2263,0,0,0,0,0,0,LO
LO,WMS58,MS20,18,1,1210,3,N,1,0,10,NO,224,319,-95,20140821,20141126,MS,3,32,5,1799,27,11,1915,5,6,116,-5,6,116,LO
LO,WMS44,MS70,7,2,1413,3,F,1,0,10,NO,281,199,82,20140917,20141224,MS,4,53,9,2263,35,10,2724,18,1,461,-18,1,461,LO
LO,WMS26,MS20,23,2,1436,2,N,1,0,10,NO,224,220,4,20140821,20141126,MS,3,35,6,1485,27,11,1915,8,5,430,-8,5,430,LO
LO,WMS53,MS40,13,2,1422,1,N,1,0,10,NO,243,499,-256,20140917,20141126,MS,3,0,41,3900,47,8,2277,47,33,1623,47,-33,-1623,HI
LO,WMS53,MS18,10,1,1157,1,N,0,NA,NA,NO,139,499,-360,20140821,20141224,MS,4,0,41,3900,42,11,731,42,30,3169,42,-30,-3169,HI
LO,WMS42,MS111,11,1,1159,3,F,1,0,10,NO,196,201,-5,20141008,20141224,MS,4,36,10,1140,61,0,1417,25,10,277,25,-10,277,LO
LO,WMS42,MS42,6,2,1411,1,M,1,0,10,YES,201,201,0,20140917,20141126,MS,3,36,10,1140,36,10,1140,0,0,0,0,0,0,LO
LO,WMS39,MS14,8,1,1159,3,N,1,1,4,NO,339,765,-426,20140821,20141012,MS,1,0,31,6885,1,24,3535,1,7,3350,1,-7,-3350,HI
LO,WMS17,MS14,20,3,1735,3,F,0,NA,NA,NO,339,802,-463,20140821,20141012,MS,1,0,24,5481,1,24,3535,1,0,1946,1,0,-1946,HI
LO,WMS20,MS24,3,2,1407,1,N,1,1,1,NO,291,224,67,20140821,20141119,MS,3,27,11,1915,41,14,2828,14,3,913,14,3,913,LO
LO,WMS50,MS50,14,2,1423,1,F,1,1,6,YES,264,264,0,20140917,20141217,MS,4,22,15,1873,22,15,1873,0,0,0,0,0,0,LO
LO,WMS53,MS40,13,2,1422,3,F,1,0,10,NO,243,499,-256,20140917,20141126,MS,3,0,41,3900,47,8,2277,47,33,1623,47,-33,-1623,HI
LO,WMS40,MS40,8,1,1155,2,M,1,0,10,YES,243,243,0,20140917,20141126,MS,3,47,8,2277,47,8,2277,0,0,0,0,0,0,LO
LO,WMS46,MS46,1,3,1655,3,N,0,NA,NA,YES,276,276,0,20140917,20141022,MS,1,38,34,2476,38,34,2476,0,0,0,0,0,0,LO
LO,WMS58,MS58,4,3,1631,2,N,1,0,10,YES,319,319,0,20140917,20141210,MS,4,32,5,1799,32,5,1799,0,0,0,0,0,0,LO
LO,WMS39,BB12,8,2,1436,1,F,0,NA,NA,NO,250,765,-515,20140822,20141022,BB,1,0,31,6885,40,12,1789,40,19,5096,40,-19,-5096,HI
LO,WMS46,MS46,1,3,1655,2,M,0,NA,NA,YES,276,276,0,20140917,20141022,MS,1,38,34,2476,38,34,2476,0,0,0,0,0,0,LO
LO,WMS24,MS44,16,2,1426,3,M,0,NA,NA,NO,199,291,-92,20140917,20141119,MS,3,41,14,2828,53,9,2263,12,5,565,12,-5,-565,LO
LO,WMS28,BB30,2,3,1714,3,F,0,NA,NA,NO,261,328,-67,20140917,20141112,BB,2,45,9,2278,37,8,2893,8,1,615,-8,-1,615,LO
LO,WMS28,MS28,10,1,1303,1,F,0,NA,NA,YES,328,328,0,20140821,20141112,MS,2,45,9,2278,45,9,2278,0,0,0,0,0,0,LO
LO,WMS58,MS20,18,1,1210,2,F,1,0,10,NO,224,319,-95,20140821,20141126,MS,3,32,5,1799,27,11,1915,5,6,116,-5,6,116,LO
LO,WMS53,MS40,13,2,1422,2,M,1,0,10,NO,243,499,-256,20140917,20141126,MS,3,0,41,3900,47,8,2277,47,33,1623,47,-33,-1623,HI
LO,WMS44,MS70,7,2,1413,2,M,1,0,10,NO,281,199,82,20140917,20141224,MS,4,53,9,2263,35,10,2724,18,1,461,-18,1,461,LO
LO,WMS69,BB52,14,3,1649,1,F,1,0,10,NO,202,787,-585,20140917,20141217,BB,4,0,11,2748,37,10,1225,37,1,1523,37,-1,-1523,HI
LO,WMS24,MS58,22,1,1217,3,N,1,1,6,NO,319,291,28,20140917,20141210,MS,4,41,14,2828,32,5,1799,9,9,1029,-9,-9,-1029,LO
LO,WMS69,MS42,1,1,1142,3,F,0,NA,NA,NO,201,787,-586,20140917,20141126,MS,3,0,11,2748,36,10,1140,36,1,1608,36,-1,-1608,HI
LO,WMS20,MS26,6,1,1150,2,N,1,1,6,NO,220,224,-4,20140821,20141119,MS,3,27,11,1915,35,6,1485,8,5,430,8,-5,-430,LO
LO,WMS26,MS64,9,1,1156,2,N,1,1,4,NO,316,220,96,20140917,20141217,MS,4,35,6,1485,26,15,1598,9,9,113,-9,9,113,LO
LO,WMS28,MS8,19,2,1538,1,M,0,NA,NA,NO,381,328,53,20140821,20141029,MS,2,45,9,2278,0,21,2461,45,12,183,-45,12,183,LO
LO,WMS69,BB52,14,3,1649,2,M,1,0,10,NO,202,787,-585,20140917,20141217,BB,4,0,11,2748,37,10,1225,37,1,1523,37,-1,-1523,HI
LO,WMS70,MS70,21,1,1216,2,N,1,1,8,YES,281,281,0,20140917,20141224,MS,4,35,10,2724,35,10,2724,0,0,0,0,0,0,LO
LO,WMS53,MS18,10,1,1157,2,F,0,NA,NA,NO,139,499,-360,20140821,20141224,MS,4,0,41,3900,42,11,731,42,30,3169,42,-30,-3169,HI
LO,WMS43,MS28,17,3,1737,3,F,0,NA,NA,NO,328,749,-421,20140821,20141112,MS,2,0,3,4004,45,9,2278,45,6,1726,45,6,-1726,HI
LO,WMS46,BB22,16,2,1453,2,N,1,1,4,NO,244,276,-32,20140822,20141112,BB,1,38,34,2476,58,8,2134,20,26,342,20,-26,-342,LO
LO,WMS50,MS50,14,2,1423,3,N,1,0,10,YES,264,264,0,20140917,20141217,MS,4,22,15,1873,22,15,1873,0,0,0,0,0,0,LO
LO,WMS53,MS18,10,1,1157,3,M,0,NA,NA,NO,139,499,-360,20140821,20141224,MS,4,0,41,3900,42,11,731,42,30,3169,42,-30,-3169,HI
